Arapaho:	Arapahoes	Arapahos
Brittany:	Brittanies	Brittanys
Emmy:	Emmies	Emmys
February:	Februaries	Februarys
Herero:	Hereroes	Hereros
Idaho:	Idahoes	Idahos
January:	Januaries	Januarys
Leonid:	Leonides	Leonids
Mandingo:	Mandingoes	Mandingos
Memento:	Mementoes	Mementos
Monsignor:	Monsignori	Monsignors
Morisco:	Moriscoes	Moriscos
Naiad:	Naiades	Naiads
Navaho:	Navahoes	Navahos
Navajo:	Navajoes	Navajos
Negrillo:	Negrilloes	Negrillos
Negrito:	Negritoes	Negritos
Nimby:	Nimbies	Nimbys
Oceanid:	Oceanides	Oceanids
Omayyad:	Omayyades	Omayyads
Ommiad:	Ommiades	Ommiads
Pleiad:	Pleiades	Pleiads
Punchinello:	Punchinelloes	Punchinellos
Reichstag:	Reichstag	Reichstags
Senhor:	Senhores	Senhors
Senor:	Senores	Senors
Tony:	Tonies	Tonys
Waf:	Wafs	Waves
Winnebago:	Winnebagoes	Winnebagos
abacus:	abaci	abacuses
abductor:	abductores	abductors
abhenry:	abhenries	abhenrys
abide:	abided	abode
abscissa:	abscissae	abscissas
abye:	abyeing	abying
acanthus:	acanthi	acanthus	acanthuses
acouchi:	acouchies	acouchis
acquit:	acquited	acquitted
acquit:	acquiting	acquitting
adieu:	adieus	adieux
administratrix:	administratrices	administratrixes
agami:	agamies	agamis
agape:	agapae	agapai	agapes
age:	ageing	aging
ageratum:	ageratum	ageratums
agouti:	agouties	agoutis
airbus:	airbuses	airbusses
albedo:	albedoes	albedos
alder:	alder	alders
alga:	algae	algas
alibi:	alibies	alibis
alight:	alighted	alit
alkali:	alkalies	alkalis
allantoid:	allantoides	allantoids
alluvion:	alluvia	alluvions
alluvium:	alluvia	alluviums
alnico:	alnicoes	alnicos
alphosis:	alphoses	alphosises
altocumulus:	altocumuli	altocumulus
ambari:	ambaries	ambaris
ambuscado:	ambuscadoes	ambuscados
ameba:	amebae	amebas
amnion:	amnia	amnions
amoeba:	amoebae	amoebas
amphora:	amphorae	amphoras
anchorperson:	anchorpeople	anchorpersons
anchovy:	anchovies	anchovy
anecdote:	anecdota	anecdotes
angelfish:	angelfish	angelfishes
antalkali:	antalkalies	antalkalis
ante:	anted	anteed
ante:	anteing	anting
anthelix:	anthelices	anthelixes
anthrax:	anthraces	anthraxes
antihelix:	antihelices	antihelixes
antipasto:	antipasti	antipastos
antiserum:	antisera	antiserums
anus:	ani	anuses
anvil:	anviled	anvilled
anvil:	anviling	anvilling
aorta:	aortae	aortas
apex:	apexes	apices
aphelion:	aphelia	aphelions
aphid:	aphides	aphids
apologia:	apologiae	apologias
apotheosis:	apotheoses	apotheosises
apparatus:	apparatus	apparatuses
apparel:	appareled	apparelled
apparel:	appareling	apparelling
aqua:	aquae	aquas
aquarium:	aquaria	aquariums
arbor:	arbores	arbors
arboretum:	arboreta	arboretums
arc:	arced	arcked
arc:	arcing	arcking
archipelago:	archipelagoes	archipelagos
armful:	armfuls	armsful
arras:	arras	arrases
arteritis:	arteritides	arteritises
ascarid:	ascarides	ascarids
asparagus:	asparagus	asparaguses
atrium:	atria	atriums
auditorium:	auditoria	auditoriums
aura:	aurae	auras
aureola:	aureolae	aureolas
aurora:	aurorae	auroras
austral:	australes	australs
autobahn:	autobahnen	autobahns
autobus:	autobuses	autobusses
automaton:	automata	automatons
avgas:	avgases	avgasses
aviatrix:	aviatrices	aviatrixes
avocado:	avocadoes	avocados
awake:	awaked	awoke	awoken
awe:	aweing	awing
ax:	aces	axes
ay:	ayes	ays
bacchanalia:	bacchanalia	bacchanalias
bach:	baches	bachs
backlight:	backlighted	backlit
backpedal:	backpedaled	backpedalled
backpedal:	backpedaling	backpedalling
backslide:	backslid	backslidden
bagful:	bagfuls	bagsful
bal:	baled	balled
bal:	baling	balling
bandeau:	bandeaus	bandeaux
bandit:	bandits	banditti
banjo:	banjoes	banjos
barbasco:	barbascoes	barbascos
barramundi:	barramundies	barramundis
barrel:	barreled	barrelled
barrel:	barreling	barrelling
barricado:	barricadoes	barricados
barrico:	barricoes	barricos
bas:	bases	basses
basset:	basseted	bassetted
basset:	basseting	bassetting
basso:	bassi	bassos
bastinado:	bastinadoes	bastinados
baud:	baud	bauds
bayadeer:	bayadeer	bayadeers
bayonet:	bayoneted	bayonetted
bayonet:	bayoneting	bayonetting
be:	are	art
be:	was	wast
bear:	born	borne
beat:	beat	beaten
beau:	beaus	beaux
becudgel:	becudgeled	becudgelled
becudgel:	becudgeling	becudgelling
becurse:	becursed	becurst
bedevil:	bedeviled	bedevilled
bedevil:	bedeviling	bedevilling
bedrivel:	bedriveled	bedrivelled
bedrivel:	bedriveling	bedrivelling
beefalo:	beefaloes	beefalos
beget:	begat	begot	begotten
begird:	begirded	begirt
behoof:	behoofs	behooves
bejewel:	bejeweled	bejewelled
bejewel:	bejeweling	bejewelling
beleap:	beleaped	beleapt
belief:	beliefs	believes
benefit:	benefited	benefitted
benefit:	benefiting	benefitting
bereave:	bereaved	bereft
berob:	berobbed	berobed
beseech:	beseeched	besought
bespeak:	bespake	bespoke	bespoken
bestrew:	bestrewed	bestrewn
bestride:	bestrid	bestridden	bestrode
bet:	bet	betted
betrothed:	betrothed	betrotheds
bevel:	beveled	bevelled
bevel:	beveler	beveller
bevel:	beveling	bevelling
bevelling:	bevelling	bevellings
bewrap:	bewrapped	bewrapt
biali:	bialies	bialis
bialy:	bialies	bialys
bias:	biased	biassed
bias:	biases	biasses
bias:	biasing	biassing
biceps:	biceps	bicepses
bid:	bid	bidden
bide:	bided	bode
biennium:	biennia	bienniums
bilbo:	bilboes	bilbos
bimbo:	bimboes	bimbos
binge:	bingeing	binging
biogas:	biogases	biogasses
biscuit:	biscuit	biscuits
bison:	bison	bisons
blackbuck:	blackbuck	blackbucks
blend:	blended	blent
bless:	blessed	blest
blow:	blew	blowed	blown
blue:	blueing	bluing
bobbysock:	bobbysocks	bobbysox
bocci:	boccies	boccis
bogey:	bogeyed	bogied
bolivar:	bolivares	bolivars
bolshevik:	bolsheviki	bolsheviks
boney:	boneyer	bonier
boney:	boneyest	boniest
bongo:	bongoes	bongos
bonito:	bonito	bonitoes	bonitos
boogie:	boogieing	boogying
borax:	boraces	boraxes
botargo:	botargoes	botargos
bowel:	boweled	bowelled
bowel:	boweling	bowelling
bowstring:	bowstringed	bowstrung
box:	box	boxes
brach:	braches	brachs
bravado:	bravadoes	bravados
bravo:	bravi	bravoes	bravos
bravura:	bravuras	bravure
brevet:	breveted	brevetted
brevet:	breveting	brevetting
brewski:	brewskies	brewskis
bris:	brises	brisses
broadcast:	broadcast	broadcasted
broch:	broches	brochs
brontosaurus:	brontosauri	brontosauruses
buck:	buck	bucks
bucko:	buckoes	buckos
buffalo:	buffaloes	buffalos
build:	builded	built
bullshit:	bullshat	bullshit
bunco:	buncoes	buncos
bunko:	bunkoes	bunkos
bureau:	bureaus	bureaux
burn:	burned	burnt
bursa:	bursae	bursas
burst:	burst	bursted
bus:	bused	bussed
bus:	buses	busses
bus:	busing	bussing
bushbuck:	bushbuck	bushbucks
bushel:	busheled	bushelled
bushel:	busheling	bushelling
bushelling:	bushelling	bushellings
bushgoat:	bushgoat	bushgoats
businessperson:	businesspeople	businesspersons
bust:	bust	busted
buttinski:	buttinskies	buttinskis
by:	byes	bys
bypass:	bypassed	bypast
cablecast:	cablecast	cablecasted
cactus:	cacti	cactus	cactuses
caesura:	caesurae	caesuras
cafe:	cafes	caves
calamanco:	calamancoes	calamancos
calamari:	calamaries	calamaris
calculus:	calculi	calculuses
calf:	calfs	calves
calico:	calicoes	calicos
calypso:	calypsoes	calypsos
calyx:	calyces	calyxes
camas:	camases	camasses
cambium:	cambia	cambiums
camisado:	camisadoes	camisados
campanile:	campaniles	campanili
can:	can	canst
canal:	canaled	canalled
canal:	canaling	canalling
cancel:	canceled	cancelled
cancel:	canceling	cancelling
candelabrum:	candelabra	candelabrums
cannon:	cannon	cannons
canoe:	canoeing	canoing
canterbury:	canterburies	canterburys
cantharid:	cantharides	cantharids
canvas:	canvased	canvassed
canvas:	canvases	canvasses
canvas:	canvasing	canvassing
caracol:	caracoled	caracolled
caracol:	caracoling	caracolling
carapax:	carapaces	carapaxes
caravan:	caravaned	caravanned
caravan:	caravaning	caravanning
caravanserai:	caravanserai	caravanserais
carbonado:	carbonadoes	carbonados
carburet:	carbureted	carburetted
carburet:	carbureting	carburetting
carcinoma:	carcinomas	carcinomata
carditis:	carditides	carditises
cargo:	cargoes	cargos
carol:	caroled	carolled
carol:	caroling	carolling
carpus:	carpi	carpuses
caryatid:	caryatides	caryatids
catalo:	cataloes	catalos
cattalo:	cattaloes	cattalos
caucus:	caucused	caucussed
caucus:	caucuses	caucusses
caucus:	caucusing	caucussing
caudex:	caudexes	caudices
caul:	caules	cauls
caveat:	caveated	caveatted
caveat:	caveating	caveatting
cavil:	caviled	cavilled
cavil:	caviling	cavilling
cavilling:	cavilling	cavillings
cello:	celli	cellos
cementum:	cementa	cementums
centre:	centreing	centring
cephalothorax:	cephalothoraces	cephalothoraxes
cerebellum:	cerebella	cerebellums
cerebrum:	cerebra	cerebrums
cervix:	cervices	cervixes
chagrin:	chagrined	chagrinned
chagrin:	chagrining	chagrinning
chairman:	chairmaned	chairmanned
chairman:	chairmaning	chairmanning
chamois:	chamois	chamoix
channel:	channeled	channelled
channel:	channeling	channelling
channelling:	channelling	channellings
chap:	chapped	chapt
chapati:	chapaties	chapatis
chapatti:	chapatties	chapattis
chapeau:	chapeaus	chapeaux
chapel:	chapeled	chapelled
chapel:	chapeling	chapelling
charisma:	charismas	charismata
chas:	chases	chasses
chateau:	chateaus	chateaux
cheechako:	cheechakoes	cheechakos
cherub:	cherubim	cherubims
chide:	chid	chidden	chided
chili:	chilies	chilis
chilli:	chillies	chillis
chirrup:	chirruped	chirrupped
chirrup:	chirruping	chirrupping
chisel:	chiseled	chiselled
chisel:	chiseling	chiselling
chiselling:	chiselling	chisellings
chiz:	chized	chizzed
chiz:	chizes	chizzes
chiz:	chizing	chizzing
chlamydia:	chlamydiae	chlamydias
chorus:	chorused	chorussed
chorus:	choruses	chorusses
chorus:	chorusing	chorussing
chrysalid:	chrysalides	chrysalids
chrysalis:	chrysalides	chrysalises
cicada:	cicadae	cicadas
cicatrix:	cicatrices	cicatrixes
cicerone:	cicerones	ciceroni
cirrus:	cirri	cirrus
cisco:	ciscoes	ciscos
citrus:	citrus	citruses
claro:	claroes	claros
cleave:	cleaved	cleft	clove	cloven
clef:	clefs	cleves
clip:	clipped	clipt
clitoris:	clitorides	clitorises
cloaca:	cloacae	cloacas
clothe:	clad	clothed
cloverleaf:	cloverleafs	cloverleaves
clue:	clueing	cluing
coadjutrix:	coadjutrices	coadjutrixes
coccyx:	coccyges	coccyxes
cochlea:	cochleae	cochleas
cocounsel:	cocounseled	cocounselled
cocounsel:	cocounseling	cocounselling
cognomen:	cognomens	cognomina
coif:	coifed	coiffed
coif:	coiffing	coifing
colcannon:	colcannon	colcannons
colloquium:	colloquia	colloquiums
colossus:	colossi	colossuses
combat:	combated	combatted
combat:	combating	combatting
commando:	commandoes	commandos
compendium:	compendia	compendiums
complex:	complexes	complices
concerto:	concerti	concertos
conch:	conches	conchs
condo:	condoes	condos
condominium:	condominia	condominiums
condor:	condores	condors
conge:	conged	congeed
congo:	congoes	congos
congressperson:	congresspeople	congresspersons
conjunctiva:	conjunctivae	conjunctivas
conquistador:	conquistadores	conquistadors
consortium:	consortia	consortiums
continuum:	continua	continuums
cooccur:	cooccuring	cooccurring
copula:	copulae	copulas
coranto:	corantoes	corantos
corbel:	corbeled	corbelled
corbel:	corbeling	corbelling
corbelling:	corbelling	corbellings
corona:	coronae	coronas
corpus:	corpora	corpuses
cortex:	cortexes	cortices
cos:	coses	cosses
cosmos:	cosmos	cosmoses
cost:	cost	costed
cottonseed:	cottonseed	cottonseeds
coulis:	coulises	coulisses
counsel:	counseled	counselled
counsel:	counseling	counselling
counselling:	counselling	counsellings
countersink:	countersank	countersunk
couranto:	courantoes	courantos
cow:	cows	kine
craftsperson:	craftspeople	craftspersons
crambo:	cramboes	crambos
cranium:	crania	craniums
credential:	credentialed	credentialled
credential:	credentialing	credentialling
crematorium:	crematoria	crematoriums
crenel:	creneled	crenelled
crenel:	creneling	crenelling
crescendo:	crescendi	crescendoes	crescendos
criterion:	criteria	criterions
crocus:	croci	crocus	crocuses
crowfoot:	crowfeet	crowfoots
cruel:	crueler	crueller
cruel:	cruelest	cruellest
cruor:	cruores	cruors
crusado:	crusadoes	crusados
crux:	cruces	cruxes
cruzado:	cruzadoes	cruzados
crystal:	crystaled	crystalled
crystal:	crystaling	crystalling
cudgel:	cudgeled	cudgelled
cudgel:	cudgeling	cudgelling
cudgelling:	cudgelling	cudgellings
cue:	cueing	cuing
culex:	culexes	culices
cumulonimbus:	cumulonimbi	cumulonimbus	cumulonimbuses
cumulus:	cumuli	cumulus
cupel:	cupeled	cupelled
cupel:	cupeling	cupelling
cupful:	cupfuls	cupsful
curf:	curfs	curves
curia:	curiae	curias
curriculum:	curricula	curriculums
curse:	cursed	curst
cursor:	cursores	cursors
curvet:	curveted	curvetted
curvet:	curveting	curvetting
cuspid:	cuspides	cuspids
cutlas:	cutlases	cutlasses
cymbalo:	cymbaloes	cymbalos
cypres:	cypreses	cypresses
cyprid:	cyprides	cyprids
dado:	dadoes	dados
dago:	dagoes	dagos
damned:	damndest	damnedest
danish:	danish	danishes
darcy:	darcies	darcys
dare:	dared	durst
daydream:	daydreamed	daydreamt
daylight:	daylighted	daylit
dead:	dead	deads
decal:	decaled	decalled
decal:	decaling	decalling
decrescendo:	decrescendi	decrescendos
deer:	deer	deers
def:	defer	deffer
defi:	defies	defis
defocus:	defocused	defocussed
defocus:	defocuses	defocusses
defocus:	defocusing	defocussing
defuel:	defueled	defuelled
defuel:	defueling	defuelling
degas:	degases	degasses
delf:	delfs	delves
delirium:	deliria	deliriums
delphinium:	delphinia	delphiniums
deprogram:	deprogramed	deprogrammed
deprogram:	deprograming	deprogramming
dermatitis:	dermatitides	dermatitises
desperado:	desperadoes	desperados
dessertspoonful:	dessertspoonfuls	dessertspoonsful
detassel:	detasseled	detasselled
detassel:	detasseling	detasselling
devel:	develed	develled
devel:	develing	develling
devil:	deviled	devilled
devil:	deviling	devilling
dex:	dexes	dices
dezinc:	dezinced	dezincked
dezinc:	dezincing	dezincking
diagram:	diagramed	diagrammed
diagram:	diagraming	diagramming
dial:	dialed	dialled
dial:	dialing	dialling
dialling:	dialling	diallings
diazo:	diazoes	diazos
dicky:	dickies	dickys
dictum:	dicta	dictums
dido:	didoes	didos
dig:	digged	dug
digestif:	digestifs	digestives
dildo:	dildoes	dildos
dilettante:	dilettantes	dilettanti
dilli:	dillies	dillis
diminuendo:	diminuendoes	diminuendos
directrix:	directrices	directrixes
disbelief:	disbeliefs	disbelieves
disbowel:	disboweled	disbowelled
disbowel:	disboweling	disbowelling
disco:	disci	discos
discus:	disci	discuses	discusses
disembowel:	disemboweled	disembowelled
disembowel:	disemboweling	disembowelling
disequilibrium:	disequilibria	disequilibriums
dishevel:	disheveled	dishevelled
dishevel:	disheveling	dishevelling
dismal:	dismaler	dismaller
dismal:	dismalest	dismallest
disprove:	disproved	disproven
ditto:	dittoes	dittos
dive:	dived	dove
djinn:	djinn	djinns
do:	did	didst
do:	do's	dos
do:	does	dost	doth
dodo:	dodoes	dodos
dogma:	dogmas	dogmata
dognap:	dognaped	dognapped
dognap:	dognaping	dognapping
dol:	doled	dolled
dol:	doling	dolling
dominatrix:	dominatrices	dominatrixes
domino:	dominoes	dominos
dos:	doses	dosses
dowel:	doweled	dowelled
dowel:	doweling	dowelling
drachma:	drachmae	drachmai	drachmas
dream:	dreamed	dreamt
drink:	drank	drunk
drivel:	driveled	drivelled
drivel:	driveling	drivelling
drongo:	drongoes	drongos
droshky:	droshkies	droshkys
drosky:	droskies	droskys
dry:	drier	dryer
dry:	dries	drys
dry:	driest	dryest
dryad:	dryades	dryads
duel:	dueled	duelled
duel:	dueling	duelling
duelling:	duelling	duellings
duodenum:	duodena	duodenums
dux:	duces	duxes
dwarf:	dwarfs	dwarves
dwell:	dwelled	dwelt
dybbuk:	dybbukim	dybbuks
dye:	dyeing	dying
earthwolf:	earthwolf	earthwolves
ecesis:	eceses	ecesises
echo:	echoes	echos
edema:	edemas	edemata
effluvium:	effluvia	effluviums
elf:	elfs	elves
embargo:	embargoes	embargos
embowel:	emboweled	embowelled
embowel:	emboweling	embowelling
emerita:	emeritae	emeritas
empanel:	empaneled	empanelled
empanel:	empaneling	empanelling
emporium:	emporia	emporiums
enamel:	enameled	enamelled
enamel:	enameling	enamelling
enamelling:	enamelling	enamellings
encomium:	encomia	encomiums
endameba:	endamebae	endamebas
endamoeba:	endamoebae	endamoebas
enema:	enemas	enemata
engrave:	engraved	engraven
enhalo:	enhaloes	enhalos
enigma:	enigmas	enigmata
enosis:	enoses	enosises
ensorcel:	ensorceled	ensorcelled
ensorcel:	ensorceling	ensorcelling
enteritis:	enteritides	enteritises
enuresis:	enureses	enuresises
ephemera:	ephemerae	ephemeras
ephemerid:	ephemerides	ephemerids
epicalyx:	epicalyces	epicalyxes
epiglottis:	epiglottides	epiglottises
epithelium:	epithelia	epitheliums
epoxy:	epoxied	epoxyed
equal:	equaled	equalled
equal:	equaling	equalling
equilibrium:	equilibria	equilibriums
eringo:	eringoes	eringos
eryngo:	eryngoes	eryngos
esophagus:	esophagi	esophaguses
esthesis:	estheses	esthesises
eucalyptus:	eucalypti	eucalyptuses
evil:	eviler	eviller
evil:	evilest	evillest
ex:	exes	ices
executrix:	executrices	executrixes
eyas:	eyases	eyasses
eye:	eyeing	eying
eye:	eyen	eyes	eyne
eyelet:	eyeleted	eyeletted
eyelet:	eyeleting	eyeletting
facet:	faceted	facetted
facet:	faceting	facetting
facsimile:	facsimileing	facsimiling
fandango:	fandangoes	fandangos
far:	farther	further
far:	farthest	furthest
farebeat:	farebeat	farebeaten
farrago:	farragoes	farragos
fascia:	fasciae	fascias
fatso:	fatsoes	fatsos
fauna:	faunae	faunas
fax:	faces	faxes
fellowship:	fellowshiped	fellowshipped
fellowship:	fellowshiping	fellowshipping
femur:	femora	femurs
ferrel:	ferreled	ferrelled
ferrel:	ferreling	ferrelling
fetial:	fetiales	fetials
fettuccine:	fettuccine	fettuccines
fez:	fezes	fezzes
fianchetto:	fianchettoes	fianchettos
fiasco:	fiascoes	fiascos
fibrosarcoma:	fibrosarcomas	fibrosarcomata
fibula:	fibulae	fibulas
fico:	ficoes	ficos
ficus:	ficus	ficuses
fieldstrip:	fieldstripped	fieldstript
fife:	fifes	fives
fil:	filed	filled
fil:	filing	filling
firstborn:	firstborn	firstborns
fistula:	fistulae	fistulas
fit:	fit	fitted
fix:	fices	fixes
fixatif:	fixatifs	fixatives
flagellum:	flagella	flagellums
flagstaff:	flagstaffs	flagstaves
flambeau:	flambeaus	flambeaux
flamingo:	flamingoes	flamingos
flan:	flanes	flans
flannel:	flanneled	flannelled
flannel:	flanneling	flannelling
floc:	flocced	flocked
floc:	floccing	flocking
floodlight:	floodlighted	floodlit
flora:	florae	floras
focus:	foci	focuses	focusses
focus:	focused	focussed
focus:	focusing	focussing
foetus:	foeti	foetuses
folk:	folk	folks
forbid:	forbad	forbade	forbid	forbidden
forceps:	forceps	forcepses	forcipes
forecast:	forecast	forecasted
forehoof:	forehoofs	forehooves
foreperson:	forepeople	forepersons
foreshow:	foreshowed	foreshown
forespeak:	forespoke	forespoken
forkful:	forkfuls	forksful
formula:	formulae	formulas
fornix:	fornices	fornixes
forspeak:	forspoke	forspoken
fortissimo:	fortissimi	fortissimos
forum:	fora	forums
frappe:	frapped	frappeed
frappe:	frappeing	frapping
fresco:	frescoes	frescos
frivol:	frivoled	frivolled
frivol:	frivoling	frivolling
frustum:	frusta	frustums
fuel:	fueled	fuelled
fuel:	fueling	fuelling
fulcrum:	fulcra	fulcrums
fumado:	fumadoes	fumados
fungus:	fungi	funguses
funnel:	funneled	funnelled
funnel:	funneling	funnelling
furfur:	furfures	furfurs
gallows:	gallows	gallowses
gambado:	gambadoes	gambados
gambol:	gamboled	gambolled
gambol:	gamboling	gambolling
ganglion:	ganglia	ganglions
gannet:	gannet	gannets
gas:	gases	gasses
gastritis:	gastritides	gastritises
gavel:	gaveled	gavelled
gavel:	gaveling	gavelling
gazabo:	gazaboes	gazabos
gazebo:	gazeboes	gazebos
gecko:	geckoes	geckos
geisha:	geisha	geishas
geld:	gelded	gelt
gemsbuck:	gemsbuck	gemsbucks
genetrix:	genetrices	genetrixes
gentlefolk:	gentlefolk	gentlefolks
genus:	genera	genuses
get:	got	gotten
gharri:	gharries	gharris
ghazi:	ghazies	ghazis
gherao:	gheraoes	gheraos
ghetto:	ghettoes	ghettos
gibbet:	gibbeted	gibbetted
gibbet:	gibbeting	gibbetting
gigahertz:	gigahertz	gigahertzes
gild:	gilded	gilt
gimbal:	gimbaled	gimballed
gimbal:	gimbaling	gimballing
gingeli:	gingelies	gingelis
gingelli:	gingellies	gingellis
gingko:	gingkoes	gingkos
ginkgo:	ginkgoes	ginkgos
ginzo:	ginzoes	ginzos
gird:	girded	girt
gladiolus:	gladioli	gladiolus	gladioluses
gland:	glandes	glands
glissando:	glissandi	glissandos
glottis:	glottides	glottises
glue:	glueing	gluing
gnaw:	gnawed	gnawn
goat:	goat	goats
gobo:	goboes	gobos
gospel:	gospeled	gospelled
gospel:	gospeler	gospeller
gospel:	gospeling	gospelling
gossip:	gossiped	gossipped
gossip:	gossiping	gossipping
gourami:	gouramies	gouramis
grapefruit:	grapefruit	grapefruits
gravamen:	gravamens	gravamina
grave:	graved	graven
gravel:	graveled	gravelled
gravel:	graveling	gravelling
greenlight:	greenlighted	greenlit
grex:	grexes	grices
grief:	griefs	grieves
groof:	groofs	grooves
grotto:	grottoes	grottos
grouse:	grouse	grouses
grovel:	groveled	grovelled
grovel:	groveling	grovelling
gruel:	grueled	gruelled
gruel:	grueling	gruelling
gruelling:	gruelling	gruellings
guacharo:	guacharoes	guacharos
guarani:	guarani	guaranies	guaranis
gulden:	gulden	guldens
gymnasium:	gymnasia	gymnasiums
haiku:	haiku	haikus
hallo:	halloes	hallos
halo:	haloes	halos
hamadryad:	hamadryades	hamadryads
handful:	handfuls	handsful
handkerchief:	handkerchiefs	handkerchieves
handsel:	handseled	handselled
handsel:	handseling	handselling
handwrite:	handwrit	handwritten
hansel:	hanseled	hanselled
hansel:	hanseling	hanselling
hatchel:	hatcheled	hatchelled
hatchel:	hatcheling	hatchelling
have:	had	hadst
have:	has	hast	hath
hawbuck:	hawbuck	hawbucks
heathen:	heathen	heathens
helix:	helices	helixes
helleri:	helleries	helleris
hello:	helloes	hellos
henry:	henries	henrys
heretrix:	heretrices	heretrixes
heritrix:	heritrices	heritrixes
hernia:	herniae	hernias
hero:	heroes	heros
hertz:	hertz	hertzes
hew:	hewed	hewn
hiatus:	hiatus	hiatuses
hiccup:	hiccuped	hiccupped
hiccup:	hiccuping	hiccupping
hide:	hid	hidden
hie:	hieing	hying
hillfolk:	hillfolk	hillfolks
hillo:	hilloes	hillos
hippopotamus:	hippopotami	hippopotamuses
hirsel:	hirseled	hirselled
hirsel:	hirseling	hirselling
hobo:	hoboes	hobos
hocus:	hocused	hocussed
hocus:	hocuses	hocusses
hocus:	hocusing	hocussing
hogtie:	hogtieing	hogtying
hollo:	holloes	hollos
honey:	honeyed	honied
honorarium:	honoraria	honorariums
hoof:	hoofs	hooves
horseshoe:	horseshod	horseshoed
hos:	hoses	hosses
hostel:	hosteled	hostelled
hostel:	hosteling	hostelling
housel:	houseled	houselled
housel:	houseling	houselling
houselling:	houselling	housellings
hovel:	hoveled	hovelled
hovel:	hoveling	hovelling
huipil:	huipiles	huipils
hullo:	hulloes	hullos
huswife:	huswifes	huswives
hydra:	hydrae	hydras
hydrocephalus:	hydrocephali	hydrocephaluses
hydrothorax:	hydrothoraces	hydrothoraxes
hyperbola:	hyperbolae	hyperbolas
hypopharynx:	hypopharynges	hypopharynxes
hypothesis:	hypotheses	hypothesises
hyrax:	hyraces	hyraxes
iambus:	iambi	iambuses
ibex:	ibexes	ibices
ictus:	ictus	ictuses
ignaro:	ignaroes	ignaros
ilex:	ilexes	ilices
ill:	iller	worse
ill:	illest	worst
imago:	imagines	imagoes	imagos
impanel:	impaneled	impanelled
impanel:	impaneling	impanelling
impatiens:	impatiens	impatienses
imperil:	imperiled	imperilled
imperil:	imperiling	imperilling
impi:	impies	impis
imshi:	imshies	imshis
incubus:	incubi	incubuses
index:	indexes	indices
indigo:	indigoes	indigos
indwell:	indwelled	indwelt
inertia:	inertiae	inertias
inheritrix:	inheritrices	inheritrixes
initial:	initialed	initialled
initial:	initialing	initialling
innuendo:	innuendoes	innuendos
input:	input	inputted
inset:	inset	insetted
intaglio:	intagli	intaglioes	intaglios
interlocutrix:	interlocutrices	interlocutrixes
intermezzo:	intermezzi	intermezzos
interplead:	interpleaded	interpled
interregnum:	interregna	interregnums
interweave:	interweaved	interwove	interwoven
interwork:	interworked	interwrought
irid:	irides	irids
iris:	irides	irises
isthmus:	isthmi	isthmuses
jacal:	jacales	jacals
jacklight:	jacklighted	jacklit
jarful:	jarfuls	jarsful
jejunum:	jejuna	jejunums
jewel:	jeweled	jewelled
jewel:	jeweling	jewelling
jigsaw:	jigsawed	jigsawn
jinni:	jinn	jinnis
journal:	journaled	journalled
journal:	journaling	journalling
jugful:	jugfuls	jugsful
junco:	juncoes	juncos
kauri:	kauries	kauris
kayo:	kayoes	kayos
keef:	keefs	keeves
kennel:	kenneled	kennelled
kennel:	kenneling	kennelling
kenosis:	kenoses	kenosises
kerchief:	kerchiefs	kerchieves
kermes:	kermeses	kermesses
kernel:	kerneled	kernelled
kernel:	kerneling	kernelling
kiddo:	kiddoes	kiddos
kidnap:	kidnaped	kidnapped
kidnap:	kidnaping	kidnapping
kielbasa:	kielbasas	kielbasi	kielbasy
killdeer:	killdeer	killdeers
kilobaud:	kilobaud	kilobauds
kilohertz:	kilohertz	kilohertzes
kinfolk:	kinfolk	kinfolks
kinsfolk:	kinsfolk	kinsfolks
kip:	kip	kips
kneel:	kneeled	knelt
kohlrabi:	kohlrabies	kohlrabis
kos:	koses	kosses
koumis:	koumises	koumisses
kris:	krised	krissed
kris:	krises	krisses
kris:	krising	krissing
kuchen:	kuchen	kuchens
kurtosis:	kurtoses	kurtosises
kvas:	kvases	kvasses
l:	les	ls
label:	labeled	labelled
label:	labeling	labelling
lac:	laced	lacked
lac:	lacing	lacking
lacuna:	lacunae	lacunas
lade:	laded	laden
lamina:	laminae	laminas
landslide:	landslid	landslidden
larva:	larvae	larvas
larynx:	larynges	larynxes
las:	lases	lasses
lasso:	lassoes	lassos
lateral:	lateraled	lateralled
lateral:	lateraling	lateralling
latex:	latexes	latices
lath:	lath	laths
latigo:	latigoes	latigos
laurel:	laureled	laurelled
laurel:	laureling	laurelling
lavabo:	lavaboes	lavabos
lax:	laces	laxes
layperson:	laypeople	laypersons
leaf:	leafs	leaves
leaflet:	leafleted	leafletted
leaflet:	leafleting	leafletting
lean:	leaned	leant
leap:	leaped	leapt	lept
learn:	learned	learnt
lemur:	lemures	lemurs
less:	least	lessest
leud:	leudes	leuds
levator:	levatores	levators
level:	leveled	levelled
level:	leveling	levelling
lexicon:	lexica	lexicons
lez:	lezes	lezzes
libel:	libeled	libelled
libel:	libeling	libelling
libretto:	libretti	librettos
light:	lighted	lit
lingo:	lingoes	lingos
linguine:	linguine	linguines
linguini:	linguini	linguinis
lira:	liras	lire
little:	least	littlest
little:	less	lesser	littler
loaf:	loafs	loaves
local:	localed	localled
local:	localing	localling
loco:	locoes	locos
locus:	loca	loci
longe:	longeing	longing
loof:	loofs	looves
looney:	looneys	loonies
loris:	loris	lorises
los:	loses	losses
lowlife:	lowlifes	lowlives
lox:	lox	loxes
loyal:	loyaler	loyaller
loyal:	loyalest	loyallest
luge:	lugeing	luging
lunge:	lungeing	lunging
lux:	luces	luxes
lymphoma:	lymphomas	lymphomata
macaroni:	macaronies	macaronis
mach:	maches	machs
macrame:	macramed	macrameed
macronucleus:	macronuclei	macronucleuses
madame:	madames	mesdames
mademoiselle:	mademoiselles	mesdemoiselles
maenad:	maenades	maenads
maestro:	maestri	maestros
mafioso:	mafiosi	mafiosos
magma:	magmas	magmata
magnifico:	magnificoes	magnificos
mambo:	mamboes	mambos
mamey:	mameyes	mameys
mango:	mangoes	mangos
manifesto:	manifestoes	manifestos
manservant:	manservants	menservants
mantis:	mantes	mantises
markka:	markkaa	markkas
marquis:	marquis	marquises
marshal:	marshaled	marshalled
marshal:	marshaling	marshalling
marshalling:	marshalling	marshallings
marvel:	marveled	marvelled
marvel:	marveling	marvelling
mas:	mases	masses
matrix:	matrices	matrixes
matzo:	matzos	matzot	matzoth
mausoleum:	mausolea	mausoleums
max:	maces	maxes
maxilla:	maxillae	maxillas
maximum:	maxima	maximums
may:	may	mayst
meane:	meaneing	meaning
medal:	medaled	medalled
medal:	medaling	medalling
medevac:	medevaced	medevacked
medevac:	medevacing	medevacking
mediatrix:	mediatrices	mediatrixes
medium:	media	mediums
medulla:	medullae	medullas
megabuck:	megabuck	megabucks
megafauna:	megafaunae	megafaunas
megahertz:	megahertz	megahertzes
melanoma:	melanomas	melanomata
melt:	melted	molten
memento:	mementoes	mementos
memorandum:	memoranda	memorandums
menfolk:	menfolk	menfolks
menhaden:	menhaden	menhadens
meniscus:	menisci	meniscuses
mes:	meses	messes
mesothorax:	mesothoraces	mesothoraxes
mesteso:	mestesoes	mestesos
mestino:	mestinoes	mestinos
mestizo:	mestizoes	mestizos
metacarpus:	metacarpi	metacarpuses
metal:	metaled	metalled
metal:	metaling	metalling
metalling:	metalling	metallings
metastasis:	metastases	metastasises
metatarsus:	metatarsi	metatarsuses
metathesis:	metatheses	metathesises
metathorax:	metathoraces	metathoraxes
miasma:	miasmas	miasmata
microbus:	microbuses	microbusses
microcosmos:	microcosmos	microcosmoses
microfauna:	microfaunae	microfaunas
microfiche:	microfiche	microfiches
microflora:	microflorae	microfloras
microfungus:	microfungi	microfunguses
microlux:	microluces	microluxes
micron:	micra	microns
micronucleus:	micronuclei	micronucleuses
midwife:	midwifed	midwived
midwife:	midwifing	midwiving
miladi:	miladies	miladis
milieu:	milieus	milieux
military:	militaries	military
millennium:	millennia	millenniums
millihenry:	millihenries	millihenrys
millilux:	milliluces	milliluxes
mimesis:	mimeses	mimesises
minibus:	minibuses	minibusses
minimum:	minima	minimums
mis:	mises	misses
misbelief:	misbeliefs	misbelieves
misbias:	misbiased	misbiassed
misbias:	misbiases	misbiasses
misbias:	misbiasing	misbiassing
mischannel:	mischanneled	mischannelled
mischannel:	mischanneling	mischannelling
miscue:	miscueing	miscuing
misdial:	misdialed	misdialled
misdial:	misdialing	misdialling
misfocus:	misfocused	misfocussed
misfocus:	misfocuses	misfocusses
misfocus:	misfocusing	misfocussing
misfuel:	misfueled	misfuelled
misfuel:	misfueling	misfuelling
mislabel:	mislabeled	mislabelled
mislabel:	mislabeling	mislabelling
mislearn:	mislearned	mislearnt
mislight:	mislighted	mislit
misplead:	mispleaded	mispled
misprogram:	misprogramed	misprogrammed
misprogram:	misprograming	misprogramming
misshape:	misshaped	misshapen
misspeak:	misspoke	misspoken
misspell:	misspelled	misspelt
misstrike:	misstricken	misstruck
miswrite:	miswrit	miswritten
mix:	mixed	mixt
model:	modeled	modelled
model:	modeling	modelling
modelling:	modelling	modellings
mojo:	mojoes	mojos
momento:	momentoes	momentos
momentum:	momenta	momentums
monad:	monades	monads
money:	moneys	monies
mongo:	mongoes	mongos
mongoose:	mongeese	mongooses
monogram:	monogramed	monogrammed
monogram:	monograming	monogramming
monopodium:	monopodia	monopodiums
monseigneur:	messeigneurs	monseigneurs
monsignor:	monsignori	monsignors
moonlight:	moonlighted	moonlit
moratorium:	moratoria	moratoriums
morsel:	morseled	morselled
morsel:	morseling	morselling
mos:	moses	mosses
mosquito:	mosquitoes	mosquitos
motif:	motifs	motives
motley:	motleyer	motlier
motley:	motleyest	motliest
motorbus:	motorbuses	motorbusses
motto:	mottoes	mottos
mow:	mowed	mown
mowburn:	mowburned	mowburnt
mulatto:	mulattoes	mulattos
multipara:	multiparae	multiparas
mungo:	mungoes	mungos
murex:	murexes	murices
mus:	muses	musses
naiad:	naiades	naiads
naif:	naifs	naives
nancy:	nancies	nancys
narcissus:	narcissi	narcissus	narcissuses
nautilus:	nautili	nautiluses
nebula:	nebulae	nebulas
neckerchief:	neckerchiefs	neckerchieves
necropolis:	necropoleis	necropoles	necropoli	necropolises
nef:	nefs	neves
neif:	neifs	neives
neocortex:	neocortexes	neocortices
nephritis:	nephritides	nephritises
nereid:	nereides	nereids
neuritis:	neuritides	neuritises
neurohypophysis:	neurohypophyses	neurohypophysises
newsperson:	newspeople	newspersons
nexus:	nexus	nexuses
nickel:	nickeled	nickelled
nickel:	nickeling	nickelling
nief:	niefs	nieves
nimbus:	nimbi	nimbuses
nisei:	nisei	niseis
no:	noes	nos
noesis:	noeses	noesises
nonequilibrium:	nonequilibria	nonequilibriums
nonplus:	nonplused	nonplussed
nonplus:	nonpluses	nonplusses
nonplus:	nonplusing	nonplussing
nosedive:	nosedived	nosedove
nova:	novae	novas
novella:	novellas	novelle
novena:	novenae	novenas
noy:	noyes	noys
nucleus:	nuclei	nucleuses
oaf:	oafs	oaves
oak:	oak	oaks
obbligato:	obbligati	obbligatos
obi:	obi	obis
obo:	oboes	obos
oceanid:	oceanides	oceanids
octopod:	octopodes	octopods
octopus:	octopi	octopuses
oesophagus:	oesophagi	oesophaguses
offspring:	offspring	offsprings
old:	elder	older
old:	eldest	oldest
omnibus:	omnibuses	omnibusses
optimum:	optima	optimums
opus:	opera	opuses
orach:	oraches	orachs
oratrix:	oratrices	oratrixes
oread:	oreades	oreads
osteosis:	osteoses	osteosises
ostosis:	ostoses	ostosises
outbid:	outbid	outbidden
outburn:	outburned	outburnt
outcavil:	outcaviled	outcavilled
outcavil:	outcaviling	outcavilling
outchide:	outchid	outchidden	outchided
outdream:	outdreamed	outdreamt
outdrink:	outdrank	outdrunk
outduel:	outdueled	outduelled
outduel:	outdueling	outduelling
outgas:	outgases	outgasses
outgeneral:	outgeneraled	outgeneralled
outgeneral:	outgeneraling	outgeneralling
outgnaw:	outgnawed	outgnawn
outleap:	outleaped	outleapt
outlearn:	outlearned	outlearnt
output:	output	outputted
outrival:	outrivaled	outrivalled
outrival:	outrivaling	outrivalling
outshine:	outshined	outshone
outsmell:	outsmelled	outsmelt
outspeak:	outspoke	outspoken
outspeed:	outsped	outspeeded
outspell:	outspelled	outspelt
outstrip:	outstripped	outstript
outwork:	outworked	outwrought
outwrite:	outwrit	outwritten
over:	overed	overred
overbear:	overborn	overborne
overbeat:	overbeat	overbeaten
overbid:	overbid	overbidden
overburn:	overburned	overburnt
overdrink:	overdrank	overdrunk
overeye:	overeyeing	overeying
overfocus:	overfocused	overfocussed
overfocus:	overfocuses	overfocusses
overfocus:	overfocusing	overfocussing
overget:	overgot	overgotten
overgild:	overgilded	overgilt
overgird:	overgirded	overgirt
overlade:	overladed	overladen
overleap:	overleaped	overleapt	overlept
overlight:	overlighted	overlit
overpass:	overpassed	overpast
overpedal:	overpedaled	overpedalled
overpedal:	overpedaling	overpedalling
overprogram:	overprogramed	overprogrammed
overprogram:	overprograming	overprogramming
overspill:	overspilled	overspilt
overstrew:	overstrewed	overstrewn
overwork:	overworked	overwrought
ox:	ox	oxen
oxymoron:	oxymora	oxymorons
oyes:	oyeses	oyesses
pac:	paced	packed
pac:	pacing	packing
pailful:	pailfuls	pailsful
pal:	paled	palled
pal:	paling	palling
palebuck:	palebuck	palebucks
paling:	paling	palings
palmetto:	palmettoes	palmettos
panel:	paneled	panelled
panel:	paneling	panelling
panelling:	panelling	panellings
papyrus:	papyri	papyruses
para:	para	paras
parador:	paradores	paradors
parallel:	paralleled	parallelled
parallel:	paralleling	parallelling
paramecium:	paramecia	parameciums
parcel:	parceled	parcelled
parcel:	parceling	parcelling
parenthesis:	parentheses	parenthesises
parget:	pargeted	pargetted
parget:	pargeting	pargetting
parquet:	parqueted	parquetted
parquet:	parqueting	parquetting
pas:	pases	passes
passado:	passadoes	passados
patchouli:	patchoulies	patchoulis
patella:	patellae	patellas
patina:	patinae	patinas
pave:	paved	paveed
pavis:	pavises	pavisses
pax:	paces	paxes
pea:	peas	pease
peccadillo:	peccadilloes	peccadillos
ped:	pedes	peds
pedal:	pedaled	pedalled
pedal:	pedaler	pedaller
pedal:	pedaling	pedalling
pedalo:	pedaloes	pedalos
pedestal:	pedestaled	pedestalled
pedestal:	pedestaling	pedestalling
pedrero:	pedreroes	pedreros
pelvis:	pelves	pelvises
pen:	penned	pent
pencil:	penciled	pencilled
pencil:	penciling	pencilling
pencilling:	pencilling	pencillings
penis:	penes	penises
penni:	pennies	pennis
penumbra:	penumbrae	penumbras
pericardium:	pericardia	pericardiums
pericranium:	pericrania	pericraniums
perihelion:	perihelia	perihelions
peril:	periled	perilled
peril:	periling	perilling
perineum:	perinea	perineums
peritoneum:	peritonea	peritoneums
person:	people	persons
persona:	personae	personas
petnap:	petnaping	petnapping
petti:	petties	pettis
phallus:	phalli	phalluses
pharynx:	pharynges	pharynxes
pheasant:	pheasant	pheasants
phenomenon:	phenomena	phenomenons
philodendron:	philodendra	philodendrons
phiz:	phizes	phizzes
phlox:	phlox	phloxes
phosphorus:	phosphori	phosphoruses
photostat:	photostated	photostatted
photostat:	photostating	photostatting
photosynthesis:	photosyntheses	photosynthesises
phylesis:	phyleses	phylesises
pianissimo:	pianissimi	pianissimos
piazza:	piazzas	piazze
picador:	picadores	picadors
pikestaff:	pikestaffs	pikestaves
pingo:	pingoes	pingos
pinko:	pinkoes	pinkos
pinon:	pinones	pinons
pintado:	pintadoes	pintados
pinto:	pintoes	pintos
pistol:	pistoled	pistolled
pistol:	pistoling	pistolling
pizzaz:	pizzazes	pizzazzes
pizzicato:	pizzicati	pizzicatos
placebo:	placeboes	placebos
placenta:	placentae	placentas
planetarium:	planetaria	planetariums
plateau:	plateaus	plateaux
plateful:	platefuls	platesful
platy:	platies	platys
platypus:	platypi	platypus	platypuses
plead:	pleaded	pled
plectrum:	plectra	plectrums
pleiad:	pleiades	pleiads
plenipo:	plenipoes	plenipos
pleura:	pleurae	pleuras
plexus:	plexus	plexuses
plus:	pluses	plusses
pneumothorax:	pneumothoraces	pneumothoraxes
pocketful:	pocketfuls	pocketsful
podium:	podia	podiums
poi:	poi	pois
pol:	poled	polled
pol:	poling	polling
politico:	politicoes	politicos
poly:	polies	polys
polyhedron:	polyhedra	polyhedrons
polyneuritis:	polyneuritides	polyneuritises
pommel:	pommeled	pommelled
pommel:	pommeling	pommelling
poof:	poofs	pooves
portico:	porticoes	porticos
portmanteau:	portmanteaus	portmanteaux
pos:	poses	posses
positif:	positifs	positives
pox:	pox	poxes
precalculus:	precalculi	precalculuses
precancel:	precanceled	precancelled
precancel:	precanceling	precancelling
precis:	precis	precises
prefocus:	prefocused	prefocussed
prefocus:	prefocuses	prefocusses
prefocus:	prefocusing	prefocussing
premix:	premixed	premixt
preprogram:	preprogramed	preprogrammed
preprogram:	preprograming	preprogramming
prepupa:	prepupae	prepupas
pres:	preses	presses
preshow:	preshowed	preshown
preshrink:	preshrank	preshrunk	preshrunken
presidium:	presidia	presidiums
presternum:	presterna	presternums
prework:	preworked	prewrought
prex:	prexes	prices
prey:	preyer	prier
primipara:	primiparae	primiparas
proboscis:	proboscides	proboscises
procambium:	procambia	procambiums
prof:	profs	proves
proglottid:	proglottides	proglottids
program:	programed	programmed
program:	programing	programming
pronator:	pronatores	pronators
prongbuck:	prongbuck	prongbucks
pronucleus:	pronuclei	pronucleuses
pronunciamento:	pronunciamentoes	pronunciamentos
pros:	proses	prosses
proscenium:	proscenia	prosceniums
prosciutto:	prosciutti	prosciuttos
prosecutrix:	prosecutrices	prosecutrixes
prothorax:	prothoraces	prothoraxes
protocol:	protocoled	protocolled
protocol:	protocoling	protocolling
protozoan:	protozoa	protozoans
protozoon:	protozoa	protozoons
prove:	proved	proven
proviso:	provisoes	provisos
pry:	pries	prys
pseudomonad:	pseudomonades	pseudomonads
psych:	psyches	psychs
pubis:	pubes	pubises
pul:	puled	pulled
pul:	puling	pulling
puma:	puma	pumas
pummel:	pummeled	pummelled
pummel:	pummeling	pummelling
pupa:	pupae	pupas
pure:	pured	pureed
pus:	puses	pusses
pylorus:	pylori	pyloruses
pyramid:	pyramides	pyramids
pyrosis:	pyroses	pyrosises
quadrennium:	quadrennia	quadrenniums
quadriceps:	quadriceps	quadricepses
quadrivium:	quadrivia	quadriviums
quaich:	quaiches	quaichs
quarrel:	quarreled	quarrelled
quarrel:	quarreling	quarrelling
quarrelling:	quarrelling	quarrellings
quarterstaff:	quarterstaffs	quarterstaves
quetzal:	quetzales	quetzals
queue:	queueing	queuing
quezal:	quezales	quezals
quit:	quit	quitted
quit:	quiting	quitting
quiz:	quizes	quizzes
rabbi:	rabbies	rabbis
rabi:	rabies	rabis
radiolabel:	radiolabeled	radiolabelled
radiolabel:	radiolabeling	radiolabelling
radius:	radii	radiuses
radix:	radices	radixes
railbus:	railbuses	railbusses
rappel:	rappeled	rappelled
rappel:	rappeling	rappelling
ras:	rases	rasses
ravel:	raveled	ravelled
ravel:	raveling	ravelling
ravelling:	ravelling	ravellings
raze:	razed	razeed
read:	readding	reading
real:	reales	reals	reis
reawake:	reawaked	reawoke	reawoken
rebato:	rebatoes	rebatos
rebid:	rebid	rebidden
rebroadcast:	rebroadcast	rebroadcasted
rebuild:	rebuilded	rebuilt
recce:	recced	recceed
rechannel:	rechanneled	rechannelled
rechannel:	rechanneling	rechannelling
reclothe:	reclad	reclothed
rectum:	recta	rectums
red:	red	redded
redial:	redialed	redialled
redial:	redialing	redialling
redream:	redreamed	redreamt
redye:	redyeing	redying
reedbuck:	reedbuck	reedbucks
reef:	reefs	reeves
reeve:	reeved	rove
ref:	refed	reffed
referendum:	referenda	referendums
refit:	refit	refitted
refocus:	refocused	refocussed
refocus:	refocuses	refocusses
refocus:	refocusing	refocussing
reformado:	reformadoes	reformados
refuel:	refueled	refuelled
refuel:	refueling	refuelling
regild:	regilded	regilt
reif:	reifs	reives
reindeer:	reindeer	reindeers
relabel:	relabeled	relabelled
relabel:	relabeling	relabelling
relearn:	relearned	relearnt
relief:	reliefs	relieves
relight:	relighted	relit
remodel:	remodeled	remodelled
remodel:	remodeling	remodelling
rend:	rended	rent
rendezvous:	rendezvous	rendezvouses
renegado:	renegadoes	renegados
repanel:	repaneled	repanelled
repanel:	repaneling	repanelling
replead:	repleaded	repled
reprogram:	reprogramed	reprogrammed
reprogram:	reprograming	reprogramming
reprove:	reproved	reproven
resew:	resewed	resewn
reshave:	reshaved	reshaven
reshow:	reshowed	reshown
residuum:	residua	residuums
resow:	resowed	resown
respeak:	respoke	respoken
respell:	respelled	respelt
respring:	resprang	resprung
restrike:	restricken	restruck
retina:	retinae	retinas
retotal:	retotaled	retotalled
retotal:	retotaling	retotalling
revel:	reveled	revelled
revel:	reveling	revelling
revelling:	revelling	revellings
revers:	revers	reverses
revictual:	revictualed	revictualled
revictual:	revictualing	revictualling
rewake:	rewaked	rewoke	rewoken
reweave:	reweaved	rewove	rewoven
rewind:	rewinded	rewound
rework:	reworked	rewrought
rewrap:	rewrapped	rewrapt
rex:	rexes	rices
rhinoceros:	rhinoceri	rhinoceroses
rhomboid:	rhomboides	rhomboids
rhombus:	rhombi	rhombuses
ricochet:	ricocheted	ricochetted
ricochet:	ricocheting	ricochetting
rid:	rid	ridded
rigatoni:	rigatoni	rigatonis
ripsaw:	ripsawed	ripsawn
rival:	rivaled	rivalled
rival:	rivaling	rivalling
rive:	rived	riven
rivet:	riveted	rivetted
rivet:	riveting	rivetting
rogue:	rogueing	roguing
rostrum:	rostra	rostrums
rotator:	rotatores	rotators
route:	routeing	routing
rowel:	roweled	rowelled
rowel:	roweling	rowelling
rubato:	rubati	rubatos
rue:	rueing	ruing
rupiah:	rupiah	rupiahs
russet:	russeting	russetting
sackful:	sackfuls	sacksful
sacrum:	sacra	sacrums
safe:	safes	saves
salesperson:	salespeople	salespersons
salmagundi:	salmagundies	salmagundis
salmonella:	salmonella	salmonellae	salmonellas
salvo:	salvoes	salvos
samurai:	samurai	samurais
sanatorium:	sanatoria	sanatoriums
sanctum:	sancta	sanctums
sandal:	sandaled	sandalled
sandal:	sandaling	sandalling
sandgrouse:	sandgrouse	sandgrouses
sanitarium:	sanitaria	sanitariums
sarcoma:	sarcomas	sarcomata
sarcophagus:	sarcophagi	sarcophaguses
sash:	sash	sashes
saute:	sauted	sauteed
saute:	sauteing	sauting
saw:	sawed	sawn
sawbones:	sawbones	sawboneses
say:	saith	says
scampi:	scampi	scampies	scampis
scandal:	scandaled	scandalled
scandal:	scandaling	scandalling
scapula:	scapulae	scapulas
scarf:	scarfs	scarves
schema:	schemas	schemata
scherzo:	scherzi	scherzos
schmo:	schmoes	schmos
schnapps:	schnapps	schnappses
schnaps:	schnaps	schnapses
schnoz:	schnozes	schnozzes
schrod:	schrod	schrods
scintilla:	scintillae	scintillas
scrod:	scrod	scrods
scrotum:	scrota	scrotums
seethe:	seethed	sod	sodden
segue:	segueing	seguing
semidwarf:	semidwarfs	semidwarves
semihobo:	semihoboes	semihobos
senhor:	senhores	senhors
senor:	senores	senors
sentinel:	sentineled	sentinelled
sentinel:	sentineling	sentinelling
septum:	septa	septums
sequin:	sequined	sequinned
seraph:	seraphim	seraphs
seraphim:	seraphim	seraphims
serf:	serfs	serves
seron:	sera	serons
serum:	sera	serums
serviceperson:	servicepeople	servicepersons
sew:	sewed	sewn
sex:	sexes	sices
shacko:	shackoes	shackos
shako:	shakoes	shakos
shall:	shall	shalt
shanti:	shanties	shantis
shave:	shaved	shaven
sheaf:	sheafs	sheaves
shear:	sheared	shorn
shindy:	shindies	shindys
shinleaf:	shinleafs	shinleaves
shit:	shat	shit
shoe:	shod	shodden	shoed
shoe:	shoes	shoon
shortwave:	shortwaveing	shortwaving
shovel:	shoveled	shovelled
shovel:	shoveling	shovelling
shovelful:	shovelfuls	shovelsful
show:	showed	shown
shrink:	shrank	shrunk	shrunken
shrive:	shrived	shriven	shrove
shrivel:	shriveled	shrivelled
shrivel:	shriveling	shrivelling
shy:	shier	shyer
shy:	shiest	shyest
sic:	sicced	sicked
sic:	siccing	sicking
signal:	signaled	signalled
signal:	signaling	signalling
signor:	signori	signors
signora:	signoras	signore
signorina:	signorinas	signorine
simplex:	simplexes	simplices
simulcast:	simulcast	simulcasted
singe:	singeing	singing
sink:	sank	sunk	sunken
sis:	sises	sisses
six:	sices	sixes
sixpence:	sixpence	sixpences
sjambok:	sjamboked	sjambokked
sjambok:	sjamboking	sjambokking
ski:	ski	skies	skis
sky:	skied	skyed
skydive:	skydived	skydove
slink:	slinked	slunk
slue:	slueing	sluing
sly:	slier	slyer
sly:	sliest	slyest
smell:	smelled	smelt
smite:	smit	smitten	smote
smooth:	smoothes	smooths
snapshot:	snapshot	snapshotted
sneak:	sneaked	snuck
snivel:	sniveled	snivelled
snivel:	sniveling	snivelling
snorkel:	snorkeled	snorkelled
snorkel:	snorkeling	snorkelling
sock:	socks	sox
solarium:	solaria	solariums
solidus:	solidi	soliduses
solo:	soli	solos
somerset:	somerseted	somersetted
somerset:	somerseting	somersetting
sonnet:	sonneted	sonnetted
sonnet:	sonneting	sonnetting
sord:	sordes	sords
sorosis:	soroses	sorosises
sow:	sowed	sown
spacecraft:	spacecraft	spacecrafts
spadix:	spadices	spadixes
spado:	spadoes	spados
spancel:	spanceled	spancelled
spancel:	spanceling	spancelling
spat:	spat	spats
speak:	spake	spoke	spoken
spec:	spec'd	specced	specked
spec:	spec'ing	speccing	specking
spectrum:	spectra	spectrums
speed:	sped	speeded
spell:	spelled	spelt
sphinx:	sphinges	sphinxes
spill:	spilled	spilt
spiral:	spiraled	spiralled
spiral:	spiraling	spiralling
spit:	spat	spit
spoil:	spoiled	spoilt
spokesperson:	spokespeople	spokespersons
spoonful:	spoonfuls	spoonsful
spotlight:	spotlighted	spotlit
spring:	sprang	sprung
springbuck:	springbuck	springbucks
springe:	springeing	springing
spry:	sprier	spryer
spry:	spriest	spryest
squash:	squash	squashes
squirrel:	squirreled	squirrelled
squirrel:	squirreling	squirrelling
staccato:	staccati	staccatos
stadium:	stadia	stadiums
staff:	staffs	staves
stag:	stag	stags
stainless:	stainless	stainlesses
stave:	staved	stove
stay:	staid	stayed
stegosaurus:	stegosauri	stegosauruses
stembuck:	stembuck	stembucks
stencil:	stenciled	stencilled
stencil:	stenciling	stencilling
stencilling:	stencilling	stencillings
sternum:	sterna	sternums
sticcado:	sticcadoes	sticcados
stiletto:	stilettoes	stilettos
stink:	stank	stunk
stomatitis:	stomatitides	stomatitises
strapless:	strapless	straplesses
strappado:	strappadoes	strappados
stratovolcano:	stratovolcanoes	stratovolcanos
stratum:	strata	stratums
stratus:	strati	stratuses
strew:	strewed	strewn
strife:	strifes	strives
strike:	stricken	struck
strip:	stripped	stript
strive:	strived	striven	strove
stucco:	stuccoes	stuccos
stylo:	styli	stylos
stylopodium:	stylopodia	stylopodiums
stylus:	styli	styluses
stymie:	stymieing	stymying
subdelirium:	subdeliria	subdeliriums
subgenus:	subgenera	subgenuses
subimago:	subimagines	subimagos
subindex:	subindexes	subindices
submaxilla:	submaxillae	submaxillas
subminimum:	subminima	subminimums
substratum:	substrata	substratums
subtotal:	subtotaled	subtotalled
subtotal:	subtotaling	subtotalling
suffix:	suffices	suffixes
sulfuret:	sulfureted	sulfuretted
sulfuret:	sulfureting	sulfuretting
sunburn:	sunburned	sunburnt
sundri:	sundries	sundris
supercargo:	supercargoes	supercargos
superhelix:	superhelices	superhelixes
superhero:	superheroes	superheros
supernova:	supernovae	supernovas
superphenomenon:	superphenomena	superphenomenons
superstratum:	superstrata	superstratums
supervirtuoso:	supervirtuosi	supervirtuosos
surplus:	surplused	surplussed
surplus:	surplusing	surplussing
swami:	swamies	swamis
swan:	swan	swans
sweat:	sweat	sweated
swell:	swelled	swollen
swinge:	swingeing	swinging
swivel:	swiveled	swivelled
swivel:	swiveling	swivelling
syllabus:	syllabi	syllabuses
symbol:	symboled	symbolled
symbol:	symboling	symbolling
symposium:	symposia	symposiums
syndesis:	syndeses	syndesises
synesis:	syneses	synesises
syngas:	syngases	syngasses
synopsis:	synopses	synopsises
synthesis:	syntheses	synthesises
tableau:	tableaus	tableaux
tablespoonful:	tablespoonfuls	tablespoonsful
tablet:	tableted	tabletted
tablet:	tableting	tabletting
tach:	taches	tachs
talc:	talced	talcked
talc:	talcing	talcking
tarantas:	tarantases	tarantasses
tarantula:	tarantulae	tarantulas
tassel:	tasseled	tasselled
tassel:	tasseling	tasselling
tasselling:	tasselling	tassellings
tax:	taces	taxes
taxi:	taxies	taxis
taxi:	taxiing	taxying
teacupful:	teacupfuls	teacupsful
teargas:	teargases	teargasses
teasel:	teaseled	teaselled
teasel:	teaseling	teaselling
teaspoonful:	teaspoonfuls	teaspoonsful
teazel:	teazeled	teazelled
teazel:	teazeling	teazelling
teetotal:	teetotaled	teetotalled
teetotal:	teetotaling	teetotalling
telecast:	telecast	telecasted
telly:	tellies	tellys
telnet:	telneted	telnetted
telnet:	telneting	telnetting
temblor:	temblores	temblors
tempo:	tempi	tempos
tenderfoot:	tenderfeet	tenderfoots
terminus:	termini	terminuses
terrarium:	terraria	terrariums
testatrix:	testatrices	testatrixes
tetrahedron:	tetrahedra	tetrahedrons
thermostat:	thermostated	thermostatted
thermostat:	thermostating	thermostatting
thesaurus:	thesauri	thesauruses
thorax:	thoraces	thoraxes
threepence:	threepence	threepences
thrive:	thrived	thriven	throve
thrust:	thrust	thrusted
thunderstrike:	thunderstricken	thunderstruck
thymus:	thymi	thymuses
tibia:	tibiae	tibias
tic:	ticced	ticked
tic:	ticcing	ticking
tie:	tieing	tying
til:	tiled	tilled
til:	tiling	tilling
tinge:	tingeing	tinging
tinsel:	tinseled	tinselled
tinsel:	tinseling	tinselling
tiro:	tiroes	tiros
tittup:	tittuped	tittupped
tittup:	tittuping	tittupping
tobacco:	tobaccoes	tobaccos
tog:	toged	togged
toga:	togae	togas
tomatillo:	tomatilloes	tomatillos
ton:	ton	tons
tornado:	tornadoes	tornados
torpedo:	torpedoes	torpedos
torso:	torsi	torsoes	torsos
tortrix:	tortrices	tortrixes
toss:	tossed	tost
total:	totaled	totalled
total:	totaling	totalling
towel:	toweled	towelled
towel:	toweling	towelling
towelling:	towelling	towellings
trachea:	tracheae	tracheas
tradesfolk:	tradesfolk	tradesfolks
tradesperson:	tradespeople	tradespersons
traditor:	traditores	traditors
tramel:	trameled	tramelled
tramel:	trameling	tramelling
trammel:	trammeled	trammelled
trammel:	trammeling	trammelling
tranquil:	tranquiler	tranquiller
tranquil:	tranquilest	tranquillest
transfix:	transfixed	transfixt
transit:	transited	transitted
transit:	transiting	transitting
trapezium:	trapezia	trapeziums
trauma:	traumas	traumata
travel:	traveled	travelled
travel:	traveler	traveller
travel:	traveling	travelling
travelling:	travelling	travellings
tread:	trod	trodden
triceps:	triceps	tricepses
triceratops:	triceratops	triceratopses
trichina:	trichinae	trichinas
trilby:	trilbies	trilbys
trolleybus:	trolleybuses	trolleybusses
troubleshoot:	troubleshooted	troubleshot
trousseau:	trousseaus	trousseaux
trowel:	troweled	trowelled
trowel:	troweling	trowelling
true:	trueing	truing
tunnel:	tunneled	tunnelled
tunnel:	tunneling	tunnelling
tunnelling:	tunnelling	tunnellings
turf:	turfs	turves
tutti:	tutties	tuttis
tuxedo:	tuxedoes	tuxedos
twinge:	twingeing	twinging
tye:	tyeing	tying
tympani:	tympani	tympanies
tympanum:	tympana	tympanums
tyro:	tyroes	tyros
ugli:	uglies	uglis
ulna:	ulnae	ulnas
ultima:	ultimas	ultimata
ultimatum:	ultimata	ultimatums
ultravacuum:	ultravacua	ultravacuums
umbilicus:	umbilici	umbilicuses
umbra:	umbrae	umbras
unbear:	unborn	unborne
unbeget:	unbegot	unbegotten
unbelief:	unbeliefs	unbelieves
unbespeak:	unbespoke	unbespoken
unbias:	unbiased	unbiassed
unbless:	unblessed	unblest
unclothe:	unclad	unclothed
underclothe:	underclad	underclothed
undergird:	undergirded	undergirt
underwork:	underworked	underwrought
unget:	ungot	ungotten
ungild:	ungilded	ungilt
ungird:	ungirded	ungirt
unglue:	unglueing	ungluing
unkennel:	unkenneled	unkennelled
unkennel:	unkenneling	unkennelling
unlade:	unladed	unladen
unlearn:	unlearned	unlearnt
unlevel:	unleveled	unlevelled
unlevel:	unleveling	unlevelling
unperson:	unpeople	unpersons
unravel:	unraveled	unravelled
unravel:	unraveling	unravelling
unravelling:	unravelling	unravellings
unreeve:	unreeved	unrove
unshoe:	unshod	unshoed
unspar:	unspared	unsparred
unspar:	unsparing	unsparring
unspeak:	unspoke	unspoken
unstrip:	unstriped	unstripped
until:	untiled	untilled
untread:	untrod	untrodden
unwork:	unworked	unwrought
up:	up	upped
upspeak:	upspake	upspoke	upspoken
upspring:	upsprang	upsprung
urethra:	urethrae	urethras
uterus:	uteri	uteruses
uveitis:	uveitides	uveitises
uvula:	uvulae	uvulas
vacuum:	vacua	vacuums
vagina:	vaginae	vaginas
veg:	veges	vegs
vermicelli:	vermicelli	vermicellis
verruca:	verrucae	verrucas
vertebra:	vertebrae	vertebras
vertex:	vertexes	vertices
vertigo:	vertigines	vertigoes	vertigos
via:	viae	vias
vial:	vialed	vialled
vial:	vialing	vialling
viator:	viatores	viators
victual:	victualed	victualled
victual:	victualing	victualling
villa:	villae	villas
virago:	viragoes	viragos
virtuoso:	virtuosi	virtuosos
vise:	vised	viseed
vise:	viseing	vising
vita:	vitae	vitas
vitriol:	vitrioled	vitriolled
vitriol:	vitrioling	vitriolling
vivarium:	vivaria	vivariums
vivax:	vivaces	vivaxes
vogue:	vogueing	voguing
volcano:	volcanoes	volcanos
vortex:	vortexes	vortices
vulva:	vulvae	vulvas
wacko:	wackoes	wackos
wadi:	wadies	wadis
waif:	waifs	waives
wainscot:	wainscoted	wainscotted
wainscot:	wainscoting	wainscotting
waitperson:	waitpeople	waitpersons
wake:	waked	woke	woken
waldo:	waldoes	waldos
wali:	walies	walis
warwolf:	warwolf	warwolves
wat:	water	watter
waterbuck:	waterbuck	waterbucks
waterbus:	waterbuses	waterbusses
wax:	waxed	waxen
weasel:	weaseled	weaselled
weasel:	weaseling	weaselling
wed:	wed	wedded
weirdo:	weirdoes	weirdos
wend:	wended	went
wendigo:	wendigoes	wendigos
werewolf:	werewolf	werewolves
wet:	wet	wetted
whacko:	whackoes	whackos
wharf:	wharfs	wharves
whinge:	whingeing	whinging
whipsaw:	whipsawed	whipsawn
wildfowl:	wildfowl	wildfowls
will:	will	wilt
will:	would	wouldst
wind:	winded	wound
windburn:	windburned	windburnt
windigo:	windigoes	windigos
winge:	wingeing	winging
wino:	winoes	winos
wireless:	wireless	wirelesses
wis:	wises	wisses
wit:	wit	wite
wiz:	wizes	wizzes
wolf:	wolf	wolves
wolverine:	wolverine	wolverines
womenfolk:	womenfolk	womenfolks
work:	worked	wrought
workfolk:	workfolk	workfolks
worship:	worshiped	worshipped
worship:	worshiping	worshipping
wrap:	wrapped	wrapt
write:	writ	written
wry:	wrier	wryer
wry:	wriest	wryest
yes:	yesed	yessed
yes:	yeses	yesses
yes:	yesing	yessing
yeshiva:	yeshivas	yeshivoth
yeshivah:	yeshivahs	yeshivoth
yobbo:	yobboes	yobbos
yodel:	yodeled	yodelled
yodel:	yodeling	yodelling
zemindari:	zemindaries	zemindaris
zero:	zeroes	zeros
zinc:	zinced	zincked
zinc:	zincing	zincking
zinc:	zincks	zincs
zloty:	zloties	zlotys
zucchini:	zucchini	zucchinis
