Arapahoes	Arapahos
Brittanies	Brittanys
Emmies	Emmys
Februaries	Februarys
Hereroes	Hereros
Idahoes	Idahos
Januaries	Januarys
Leonides	Leonids
Mandingoes	Mandingos
Mementoes	Mementos
Monsignori	Monsignors
Moriscoes	Moriscos
Naiades	Naiads
Navahoes	Navahos
Navajoes	Navajos
Negrilloes	Negrillos
Negritoes	Negritos
Nimbies	Nimbys
Oceanides	Oceanids
Omayyades	Omayyads
Ommiades	Ommiads
Pleiades	Pleiads
Punchinelloes	Punchinellos
Reichstag	Reichstags
Senhores	Senhors
Senores	Senors
Tonies	Tonys
Wafs	Waves
Winnebagoes	Winnebagos
abaci	abacuses
abductores	abductors
abhenries	abhenrys
abided	abode
abscissae	abscissas
abyeing	abying
acanthi	acanthus	acanthuses
aces	axes
acouchies	acouchis
acquited	acquitted
acquiting	acquitting
adieus	adieux
administratrices	administratrixes
agamies	agamis
agapae	agapai	agapes
ageing	aging
ageratum	ageratums
agouties	agoutis
airbuses	airbusses
albedoes	albedos
alder	alders
algae	algas
alibies	alibis
alighted	alit
alkalies	alkalis
allantoides	allantoids
alluvia	alluvions	alluviums
alnicoes	alnicos
alphoses	alphosises
altocumuli	altocumulus
ambaries	ambaris
ambuscadoes	ambuscados
amebae	amebas
amnia	amnions
amoebae	amoebas
amphorae	amphoras
anchorpeople	anchorpersons
anchovies	anchovy
anecdota	anecdotes
angelfish	angelfishes
ani	anuses
antalkalies	antalkalis
anted	anteed
anteing	anting
anthelices	anthelixes
anthraces	anthraxes
antihelices	antihelixes
antipasti	antipastos
antisera	antiserums
anviled	anvilled
anviling	anvilling
aortae	aortas
apexes	apices
aphelia	aphelions
aphides	aphids
apologiae	apologias
apotheoses	apotheosises
apparatus	apparatuses
appareled	apparelled
appareling	apparelling
aquae	aquas
aquaria	aquariums
arbores	arbors
arboreta	arboretums
arced	arcked
archipelagoes	archipelagos
arcing	arcking
are	art
armfuls	armsful
arras	arrases
arteritides	arteritises
ascarides	ascarids
asparagus	asparaguses
atria	atriums
auditoria	auditoriums
aurae	auras
aureolae	aureolas
aurorae	auroras
australes	australs
autobahnen	autobahns
autobuses	autobusses
automata	automatons
avgases	avgasses
aviatrices	aviatrixes
avocadoes	avocados
awaked	awoke	awoken
aweing	awing
ayes	ays
bacchanalia	bacchanalias
baches	bachs
backlighted	backlit
backpedaled	backpedalled
backpedaling	backpedalling
backslid	backslidden
bagfuls	bagsful
baled	balled
baling	balling
bandeaus	bandeaux
bandits	banditti
banjoes	banjos
barbascoes	barbascos
barramundies	barramundis
barreled	barrelled
barreling	barrelling
barricadoes	barricados
barricoes	barricos
bases	basses
basseted	bassetted
basseting	bassetting
bassi	bassos
bastinadoes	bastinados
baud	bauds
bayadeer	bayadeers
bayoneted	bayonetted
bayoneting	bayonetting
beat	beaten
beaus	beaux
becudgeled	becudgelled
becudgeling	becudgelling
becursed	becurst
bedeviled	bedevilled
bedeviling	bedevilling
bedriveled	bedrivelled
bedriveling	bedrivelling
beefaloes	beefalos
begat	begot	begotten
begirded	begirt
behoofs	behooves
bejeweled	bejewelled
bejeweling	bejewelling
beleaped	beleapt
beliefs	believes
benefited	benefitted
benefiting	benefitting
bereaved	bereft
berobbed	berobed
beseeched	besought
bespake	bespoke	bespoken
bestrewed	bestrewn
bestrid	bestridden	bestrode
bet	betted
betrothed	betrotheds
beveled	bevelled
beveler	beveller
beveling	bevelling	bevellings
bewrapped	bewrapt
bialies	bialis	bialys
biased	biassed
biases	biasses
biasing	biassing
biceps	bicepses
bid	bidden
bided	bode
biennia	bienniums
bilboes	bilbos
bimboes	bimbos
bingeing	binging
biogases	biogasses
biscuit	biscuits
bison	bisons
blackbuck	blackbucks
blended	blent
blessed	blest
blew	blowed	blown
blueing	bluing
bobbysocks	bobbysox
boccies	boccis
bogeyed	bogied
bolivares	bolivars
bolsheviki	bolsheviks
boneyer	bonier
boneyest	boniest
bongoes	bongos
bonito	bonitoes	bonitos
boogieing	boogying
boraces	boraxes
born	borne
botargoes	botargos
boweled	bowelled
boweling	bowelling
bowstringed	bowstrung
box	boxes
braches	brachs
bravadoes	bravados
bravi	bravoes	bravos
bravuras	bravure
breveted	brevetted
breveting	brevetting
brewskies	brewskis
brises	brisses
broadcast	broadcasted
broches	brochs
brontosauri	brontosauruses
buck	bucks
buckoes	buckos
buffaloes	buffalos
builded	built
bullshat	bullshit
buncoes	buncos
bunkoes	bunkos
bureaus	bureaux
burned	burnt
bursae	bursas
burst	bursted
bused	bussed
buses	busses
bushbuck	bushbucks
busheled	bushelled
busheling	bushelling	bushellings
bushgoat	bushgoats
businesspeople	businesspersons
busing	bussing
bust	busted
buttinskies	buttinskis
byes	bys
bypassed	bypast
cablecast	cablecasted
cacti	cactus	cactuses
caesurae	caesuras
cafes	caves
calamancoes	calamancos
calamaries	calamaris
calculi	calculuses
calfs	calves
calicoes	calicos
calyces	calyxes
calypsoes	calypsos
camases	camasses
cambia	cambiums
camisadoes	camisados
campaniles	campanili
can	canst
canaled	canalled
canaling	canalling
canceled	cancelled
canceling	cancelling
candelabra	candelabrums
cannon	cannons
canoeing	canoing
canterburies	canterburys
cantharides	cantharids
canvased	canvassed
canvases	canvasses
canvasing	canvassing
caracoled	caracolled
caracoling	caracolling
carapaces	carapaxes
caravaned	caravanned
caravaning	caravanning
caravanserai	caravanserais
carbonadoes	carbonados
carbureted	carburetted
carbureting	carburetting
carcinomas	carcinomata
carditides	carditises
cargoes	cargos
caroled	carolled
caroling	carolling
carpi	carpuses
caryatides	caryatids
cataloes	catalos
cattaloes	cattalos
caucused	caucussed
caucuses	caucusses
caucusing	caucussing
caudexes	caudices
caules	cauls
caveated	caveatted
caveating	caveatting
caviled	cavilled
caviling	cavilling	cavillings
celli	cellos
cementa	cementums
centreing	centring
cephalothoraces	cephalothoraxes
cerebella	cerebellums
cerebra	cerebrums
cervices	cervixes
chagrined	chagrinned
chagrining	chagrinning
chairmaned	chairmanned
chairmaning	chairmanning
chamois	chamoix
channeled	channelled
channeling	channelling	channellings
chapaties	chapatis
chapatties	chapattis
chapeaus	chapeaux
chapeled	chapelled
chapeling	chapelling
chapped	chapt
charismas	charismata
chases	chasses
chateaus	chateaux
cheechakoes	cheechakos
cherubim	cherubims
chid	chidden	chided
chilies	chilis
chillies	chillis
chirruped	chirrupped
chirruping	chirrupping
chiseled	chiselled
chiseling	chiselling	chisellings
chized	chizzed
chizes	chizzes
chizing	chizzing
chlamydiae	chlamydias
chorused	chorussed
choruses	chorusses
chorusing	chorussing
chrysalides	chrysalids	chrysalises
cicadae	cicadas
cicatrices	cicatrixes
cicerones	ciceroni
cirri	cirrus
ciscoes	ciscos
citrus	citruses
clad	clothed
claroes	claros
cleaved	cleft	clove	cloven
clefs	cleves
clipped	clipt
clitorides	clitorises
cloacae	cloacas
cloverleafs	cloverleaves
clueing	cluing
coadjutrices	coadjutrixes
coccyges	coccyxes
cochleae	cochleas
cocounseled	cocounselled
cocounseling	cocounselling
cognomens	cognomina
coifed	coiffed
coiffing	coifing
colcannon	colcannons
colloquia	colloquiums
colossi	colossuses
combated	combatted
combating	combatting
commandoes	commandos
compendia	compendiums
complexes	complices
concerti	concertos
conches	conchs
condoes	condos
condominia	condominiums
condores	condors
conged	congeed
congoes	congos
congresspeople	congresspersons
conjunctivae	conjunctivas
conquistadores	conquistadors
consortia	consortiums
continua	continuums
cooccuring	cooccurring
copulae	copulas
corantoes	corantos
corbeled	corbelled
corbeling	corbelling	corbellings
coronae	coronas
corpora	corpuses
cortexes	cortices
coses	cosses
cosmos	cosmoses
cost	costed
cottonseed	cottonseeds
coulises	coulisses
counseled	counselled
counseling	counselling	counsellings
countersank	countersunk
courantoes	courantos
cows	kine
craftspeople	craftspersons
cramboes	crambos
crania	craniums
credentialed	credentialled
credentialing	credentialling
crematoria	crematoriums
creneled	crenelled
creneling	crenelling
crescendi	crescendoes	crescendos
criteria	criterions
croci	crocus	crocuses
crowfeet	crowfoots
cruces	cruxes
crueler	crueller
cruelest	cruellest
cruores	cruors
crusadoes	crusados
cruzadoes	cruzados
crystaled	crystalled
crystaling	crystalling
cudgeled	cudgelled
cudgeling	cudgelling	cudgellings
cueing	cuing
culexes	culices
cumuli	cumulus
cumulonimbi	cumulonimbus	cumulonimbuses
cupeled	cupelled
cupeling	cupelling
cupfuls	cupsful
curfs	curves
curiae	curias
curricula	curriculums
cursed	curst
cursores	cursors
curveted	curvetted
curveting	curvetting
cuspides	cuspids
cutlases	cutlasses
cymbaloes	cymbalos
cypreses	cypresses
cyprides	cyprids
dadoes	dados
dagoes	dagos
damndest	damnedest
danish	danishes
darcies	darcys
dared	durst
daydreamed	daydreamt
daylighted	daylit
dead	deads
decaled	decalled
decaling	decalling
decrescendi	decrescendos
deer	deers
defer	deffer
defies	defis
defocused	defocussed
defocuses	defocusses
defocusing	defocussing
defueled	defuelled
defueling	defuelling
degases	degasses
delfs	delves
deliria	deliriums
delphinia	delphiniums
deprogramed	deprogrammed
deprograming	deprogramming
dermatitides	dermatitises
desperadoes	desperados
dessertspoonfuls	dessertspoonsful
detasseled	detasselled
detasseling	detasselling
develed	develled
develing	develling
deviled	devilled
deviling	devilling
dexes	dices
dezinced	dezincked
dezincing	dezincking
diagramed	diagrammed
diagraming	diagramming
dialed	dialled
dialing	dialling	diallings
diazoes	diazos
dickies	dickys
dicta	dictums
did	didst
didoes	didos
digestifs	digestives
digged	dug
dildoes	dildos
dilettantes	dilettanti
dillies	dillis
diminuendoes	diminuendos
directrices	directrixes
disbeliefs	disbelieves
disboweled	disbowelled
disboweling	disbowelling
disci	discos	discuses	discusses
disemboweled	disembowelled
disemboweling	disembowelling
disequilibria	disequilibriums
disheveled	dishevelled
disheveling	dishevelling
dismaler	dismaller
dismalest	dismallest
disproved	disproven
dittoes	dittos
dived	dove
djinn	djinns
do's	dos
dodoes	dodos
does	dost	doth
dogmas	dogmata
dognaped	dognapped
dognaping	dognapping
doled	dolled
doling	dolling
dominatrices	dominatrixes
dominoes	dominos
doses	dosses
doweled	dowelled
doweling	dowelling
drachmae	drachmai	drachmas
drank	drunk
dreamed	dreamt
drier	dryer
dries	drys
driest	dryest
driveled	drivelled
driveling	drivelling
drongoes	drongos
droshkies	droshkys
droskies	droskys
dryades	dryads
duces	duxes
dueled	duelled
dueling	duelling	duellings
duodena	duodenums
dwarfs	dwarves
dwelled	dwelt
dybbukim	dybbuks
dyeing	dying
earthwolf	earthwolves
eceses	ecesises
echoes	echos
edemas	edemata
effluvia	effluviums
elder	older
eldest	oldest
elfs	elves
embargoes	embargos
emboweled	embowelled
emboweling	embowelling
emeritae	emeritas
empaneled	empanelled
empaneling	empanelling
emporia	emporiums
enameled	enamelled
enameling	enamelling	enamellings
encomia	encomiums
endamebae	endamebas
endamoebae	endamoebas
enemas	enemata
engraved	engraven
enhaloes	enhalos
enigmas	enigmata
enoses	enosises
ensorceled	ensorcelled
ensorceling	ensorcelling
enteritides	enteritises
enureses	enuresises
ephemerae	ephemeras
ephemerides	ephemerids
epicalyces	epicalyxes
epiglottides	epiglottises
epithelia	epitheliums
epoxied	epoxyed
equaled	equalled
equaling	equalling
equilibria	equilibriums
eringoes	eringos
eryngoes	eryngos
esophagi	esophaguses
estheses	esthesises
eucalypti	eucalyptuses
eviler	eviller
evilest	evillest
executrices	executrixes
exes	ices
eyases	eyasses
eyeing	eying
eyeleted	eyeletted
eyeleting	eyeletting
eyen	eyes	eyne
faces	faxes
faceted	facetted
faceting	facetting
facsimileing	facsimiling
fandangoes	fandangos
farebeat	farebeaten
farragoes	farragos
farther	further
farthest	furthest
fasciae	fascias
fatsoes	fatsos
faunae	faunas
fellowshiped	fellowshipped
fellowshiping	fellowshipping
femora	femurs
ferreled	ferrelled
ferreling	ferrelling
fetiales	fetials
fettuccine	fettuccines
fezes	fezzes
fianchettoes	fianchettos
fiascoes	fiascos
fibrosarcomas	fibrosarcomata
fibulae	fibulas
fices	fixes
ficoes	ficos
ficus	ficuses
fieldstripped	fieldstript
fifes	fives
filed	filled
filing	filling
firstborn	firstborns
fistulae	fistulas
fit	fitted
fixatifs	fixatives
flagella	flagellums
flagstaffs	flagstaves
flambeaus	flambeaux
flamingoes	flamingos
flanes	flans
flanneled	flannelled
flanneling	flannelling
flocced	flocked
floccing	flocking
floodlighted	floodlit
florae	floras
foci	focuses	focusses
focused	focussed
focusing	focussing
foeti	foetuses
folk	folks
fora	forums
forbad	forbade	forbid	forbidden
forceps	forcepses	forcipes
forecast	forecasted
forehoofs	forehooves
forepeople	forepersons
foreshowed	foreshown
forespoke	forespoken
forkfuls	forksful
formulae	formulas
fornices	fornixes
forspoke	forspoken
fortissimi	fortissimos
frapped	frappeed
frappeing	frapping
frescoes	frescos
frivoled	frivolled
frivoling	frivolling
frusta	frustums
fueled	fuelled
fueling	fuelling
fulcra	fulcrums
fumadoes	fumados
fungi	funguses
funneled	funnelled
funneling	funnelling
furfures	furfurs
gallows	gallowses
gambadoes	gambados
gamboled	gambolled
gamboling	gambolling
ganglia	ganglions
gannet	gannets
gases	gasses
gastritides	gastritises
gaveled	gavelled
gaveling	gavelling
gazaboes	gazabos
gazeboes	gazebos
geckoes	geckos
geisha	geishas
gelded	gelt
gemsbuck	gemsbucks
genera	genuses
genetrices	genetrixes
gentlefolk	gentlefolks
gharries	gharris
ghazies	ghazis
gheraoes	gheraos
ghettoes	ghettos
gibbeted	gibbetted
gibbeting	gibbetting
gigahertz	gigahertzes
gilded	gilt
gimbaled	gimballed
gimbaling	gimballing
gingelies	gingelis
gingellies	gingellis
gingkoes	gingkos
ginkgoes	ginkgos
ginzoes	ginzos
girded	girt
gladioli	gladiolus	gladioluses
glandes	glands
glissandi	glissandos
glottides	glottises
glueing	gluing
gnawed	gnawn
goat	goats
goboes	gobos
gospeled	gospelled
gospeler	gospeller
gospeling	gospelling
gossiped	gossipped
gossiping	gossipping
got	gotten
gouramies	gouramis
grapefruit	grapefruits
gravamens	gravamina
graved	graven
graveled	gravelled
graveling	gravelling
greenlighted	greenlit
grexes	grices
griefs	grieves
groofs	grooves
grottoes	grottos
grouse	grouses
groveled	grovelled
groveling	grovelling
grueled	gruelled
grueling	gruelling	gruellings
guacharoes	guacharos
guarani	guaranies	guaranis
gulden	guldens
gymnasia	gymnasiums
had	hadst
haiku	haikus
halloes	hallos
haloes	halos
hamadryades	hamadryads
handfuls	handsful
handkerchiefs	handkerchieves
handseled	handselled
handseling	handselling
handwrit	handwritten
hanseled	hanselled
hanseling	hanselling
has	hast	hath
hatcheled	hatchelled
hatcheling	hatchelling
hawbuck	hawbucks
heathen	heathens
helices	helixes
helleries	helleris
helloes	hellos
henries	henrys
heretrices	heretrixes
heritrices	heritrixes
herniae	hernias
heroes	heros
hertz	hertzes
hewed	hewn
hiatus	hiatuses
hiccuped	hiccupped
hiccuping	hiccupping
hid	hidden
hieing	hying
hillfolk	hillfolks
hilloes	hillos
hippopotami	hippopotamuses
hirseled	hirselled
hirseling	hirselling
hoboes	hobos
hocused	hocussed
hocuses	hocusses
hocusing	hocussing
hogtieing	hogtying
holloes	hollos
honeyed	honied
honoraria	honorariums
hoofs	hooves
horseshod	horseshoed
hoses	hosses
hosteled	hostelled
hosteling	hostelling
houseled	houselled
houseling	houselling	housellings
hoveled	hovelled
hoveling	hovelling
huipiles	huipils
hulloes	hullos
huswifes	huswives
hydrae	hydras
hydrocephali	hydrocephaluses
hydrothoraces	hydrothoraxes
hyperbolae	hyperbolas
hypopharynges	hypopharynxes
hypotheses	hypothesises
hyraces	hyraxes
iambi	iambuses
ibexes	ibices
ictus	ictuses
ignaroes	ignaros
ilexes	ilices
iller	worse
illest	worst
imagines	imagoes	imagos
impaneled	impanelled
impaneling	impanelling
impatiens	impatienses
imperiled	imperilled
imperiling	imperilling
impies	impis
imshies	imshis
incubi	incubuses
indexes	indices
indigoes	indigos
indwelled	indwelt
inertiae	inertias
inheritrices	inheritrixes
initialed	initialled
initialing	initialling
innuendoes	innuendos
input	inputted
inset	insetted
intagli	intaglioes	intaglios
interlocutrices	interlocutrixes
intermezzi	intermezzos
interpleaded	interpled
interregna	interregnums
interweaved	interwove	interwoven
interworked	interwrought
irides	irids	irises
isthmi	isthmuses
jacales	jacals
jacklighted	jacklit
jarfuls	jarsful
jejuna	jejunums
jeweled	jewelled
jeweling	jewelling
jigsawed	jigsawn
jinn	jinnis
journaled	journalled
journaling	journalling
jugfuls	jugsful
juncoes	juncos
kauries	kauris
kayoes	kayos
keefs	keeves
kenneled	kennelled
kenneling	kennelling
kenoses	kenosises
kerchiefs	kerchieves
kermeses	kermesses
kerneled	kernelled
kerneling	kernelling
kiddoes	kiddos
kidnaped	kidnapped
kidnaping	kidnapping
kielbasas	kielbasi	kielbasy
killdeer	killdeers
kilobaud	kilobauds
kilohertz	kilohertzes
kinfolk	kinfolks
kinsfolk	kinsfolks
kip	kips
kneeled	knelt
kohlrabies	kohlrabis
koses	kosses
koumises	koumisses
krised	krissed
krises	krisses
krising	krissing
kuchen	kuchens
kurtoses	kurtosises
kvases	kvasses
labeled	labelled
labeling	labelling
laced	lacked
laces	laxes
lacing	lacking
lacunae	lacunas
laded	laden
laminae	laminas
landslid	landslidden
larvae	larvas
larynges	larynxes
lases	lasses
lassoes	lassos
lateraled	lateralled
lateraling	lateralling
latexes	latices
lath	laths
latigoes	latigos
laureled	laurelled
laureling	laurelling
lavaboes	lavabos
laypeople	laypersons
leafleted	leafletted
leafleting	leafletting
leafs	leaves
leaned	leant
leaped	leapt	lept
learned	learnt
least	lessest	littlest
lemures	lemurs
les	ls
less	lesser	littler
leudes	leuds
levatores	levators
leveled	levelled
leveling	levelling
lexica	lexicons
lezes	lezzes
libeled	libelled
libeling	libelling
libretti	librettos
lighted	lit
lingoes	lingos
linguine	linguines
linguini	linguinis
liras	lire
loafs	loaves
loca	loci
localed	localled
localing	localling
locoes	locos
longeing	longing
loofs	looves
looneys	loonies
loris	lorises
loses	losses
lowlifes	lowlives
lox	loxes
loyaler	loyaller
loyalest	loyallest
luces	luxes
lugeing	luging
lungeing	lunging
lymphomas	lymphomata
macaronies	macaronis
maces	maxes
maches	machs
macramed	macrameed
macronuclei	macronucleuses
madames	mesdames
mademoiselles	mesdemoiselles
maenades	maenads
maestri	maestros
mafiosi	mafiosos
magmas	magmata
magnificoes	magnificos
mamboes	mambos
mameyes	mameys
mangoes	mangos
manifestoes	manifestos
manservants	menservants
mantes	mantises
markkaa	markkas
marquis	marquises
marshaled	marshalled
marshaling	marshalling	marshallings
marveled	marvelled
marveling	marvelling
mases	masses
matrices	matrixes
matzos	matzot	matzoth
mausolea	mausoleums
maxillae	maxillas
maxima	maximums
may	mayst
meaneing	meaning
medaled	medalled
medaling	medalling
medevaced	medevacked
medevacing	medevacking
media	mediums
mediatrices	mediatrixes
medullae	medullas
megabuck	megabucks
megafaunae	megafaunas
megahertz	megahertzes
melanomas	melanomata
melted	molten
mementoes	mementos
memoranda	memorandums
menfolk	menfolks
menhaden	menhadens
menisci	meniscuses
meses	messes
mesothoraces	mesothoraxes
messeigneurs	monseigneurs
mestesoes	mestesos
mestinoes	mestinos
mestizoes	mestizos
metacarpi	metacarpuses
metaled	metalled
metaling	metalling	metallings
metastases	metastasises
metatarsi	metatarsuses
metatheses	metathesises
metathoraces	metathoraxes
miasmas	miasmata
micra	microns
microbuses	microbusses
microcosmos	microcosmoses
microfaunae	microfaunas
microfiche	microfiches
microflorae	microfloras
microfungi	microfunguses
microluces	microluxes
micronuclei	micronucleuses
midwifed	midwived
midwifing	midwiving
miladies	miladis
milieus	milieux
militaries	military
millennia	millenniums
millihenries	millihenrys
milliluces	milliluxes
mimeses	mimesises
minibuses	minibusses
minima	minimums
misbeliefs	misbelieves
misbiased	misbiassed
misbiases	misbiasses
misbiasing	misbiassing
mischanneled	mischannelled
mischanneling	mischannelling
miscueing	miscuing
misdialed	misdialled
misdialing	misdialling
mises	misses
misfocused	misfocussed
misfocuses	misfocusses
misfocusing	misfocussing
misfueled	misfuelled
misfueling	misfuelling
mislabeled	mislabelled
mislabeling	mislabelling
mislearned	mislearnt
mislighted	mislit
mispleaded	mispled
misprogramed	misprogrammed
misprograming	misprogramming
misshaped	misshapen
misspelled	misspelt
misspoke	misspoken
misstricken	misstruck
miswrit	miswritten
mixed	mixt
modeled	modelled
modeling	modelling	modellings
mojoes	mojos
momenta	momentums
momentoes	momentos
monades	monads
moneys	monies
mongeese	mongooses
mongoes	mongos
monogramed	monogrammed
monograming	monogramming
monopodia	monopodiums
monsignori	monsignors
moonlighted	moonlit
moratoria	moratoriums
morseled	morselled
morseling	morselling
moses	mosses
mosquitoes	mosquitos
motifs	motives
motleyer	motlier
motleyest	motliest
motorbuses	motorbusses
mottoes	mottos
mowburned	mowburnt
mowed	mown
mulattoes	mulattos
multiparae	multiparas
mungoes	mungos
murexes	murices
muses	musses
naiades	naiads
naifs	naives
nancies	nancys
narcissi	narcissus	narcissuses
nautili	nautiluses
nebulae	nebulas
neckerchiefs	neckerchieves
necropoleis	necropoles	necropoli	necropolises
nefs	neves
neifs	neives
neocortexes	neocortices
nephritides	nephritises
nereides	nereids
neuritides	neuritises
neurohypophyses	neurohypophysises
newspeople	newspersons
nexus	nexuses
nickeled	nickelled
nickeling	nickelling
niefs	nieves
nimbi	nimbuses
nisei	niseis
noes	nos
noeses	noesises
nonequilibria	nonequilibriums
nonplused	nonplussed
nonpluses	nonplusses
nonplusing	nonplussing
nosedived	nosedove
novae	novas
novellas	novelle
novenae	novenas
noyes	noys
nuclei	nucleuses
oafs	oaves
oak	oaks
obbligati	obbligatos
obi	obis
oboes	obos
oceanides	oceanids
octopi	octopuses
octopodes	octopods
oesophagi	oesophaguses
offspring	offsprings
omnibuses	omnibusses
opera	opuses
optima	optimums
oraches	orachs
oratrices	oratrixes
oreades	oreads
osteoses	osteosises
ostoses	ostosises
outbid	outbidden
outburned	outburnt
outcaviled	outcavilled
outcaviling	outcavilling
outchid	outchidden	outchided
outdrank	outdrunk
outdreamed	outdreamt
outdueled	outduelled
outdueling	outduelling
outgases	outgasses
outgeneraled	outgeneralled
outgeneraling	outgeneralling
outgnawed	outgnawn
outleaped	outleapt
outlearned	outlearnt
output	outputted
outrivaled	outrivalled
outrivaling	outrivalling
outshined	outshone
outsmelled	outsmelt
outsped	outspeeded
outspelled	outspelt
outspoke	outspoken
outstripped	outstript
outworked	outwrought
outwrit	outwritten
overbeat	overbeaten
overbid	overbidden
overborn	overborne
overburned	overburnt
overdrank	overdrunk
overed	overred
overeyeing	overeying
overfocused	overfocussed
overfocuses	overfocusses
overfocusing	overfocussing
overgilded	overgilt
overgirded	overgirt
overgot	overgotten
overladed	overladen
overleaped	overleapt	overlept
overlighted	overlit
overpassed	overpast
overpedaled	overpedalled
overpedaling	overpedalling
overprogramed	overprogrammed
overprograming	overprogramming
overspilled	overspilt
overstrewed	overstrewn
overworked	overwrought
ox	oxen
oxymora	oxymorons
oyeses	oyesses
paced	packed
paces	paxes
pacing	packing
pailfuls	pailsful
palebuck	palebucks
paled	palled
paling	palings	palling
palmettoes	palmettos
paneled	panelled
paneling	panelling	panellings
papyri	papyruses
para	paras
paradores	paradors
paralleled	parallelled
paralleling	parallelling
paramecia	parameciums
parceled	parcelled
parceling	parcelling
parentheses	parenthesises
pargeted	pargetted
pargeting	pargetting
parqueted	parquetted
parqueting	parquetting
pases	passes
passadoes	passados
patchoulies	patchoulis
patellae	patellas
patinae	patinas
paved	paveed
pavises	pavisses
peas	pease
peccadilloes	peccadillos
pedaled	pedalled
pedaler	pedaller
pedaling	pedalling
pedaloes	pedalos
pedes	peds
pedestaled	pedestalled
pedestaling	pedestalling
pedreroes	pedreros
pelves	pelvises
penciled	pencilled
penciling	pencilling	pencillings
penes	penises
penned	pent
pennies	pennis
penumbrae	penumbras
people	persons
pericardia	pericardiums
pericrania	pericraniums
perihelia	perihelions
periled	perilled
periling	perilling
perinea	perineums
peritonea	peritoneums
personae	personas
petnaping	petnapping
petties	pettis
phalli	phalluses
pharynges	pharynxes
pheasant	pheasants
phenomena	phenomenons
philodendra	philodendrons
phizes	phizzes
phlox	phloxes
phosphori	phosphoruses
photostated	photostatted
photostating	photostatting
photosyntheses	photosynthesises
phyleses	phylesises
pianissimi	pianissimos
piazzas	piazze
picadores	picadors
pikestaffs	pikestaves
pingoes	pingos
pinkoes	pinkos
pinones	pinons
pintadoes	pintados
pintoes	pintos
pistoled	pistolled
pistoling	pistolling
pizzazes	pizzazzes
pizzicati	pizzicatos
placeboes	placebos
placentae	placentas
planetaria	planetariums
plateaus	plateaux
platefuls	platesful
platies	platys
platypi	platypus	platypuses
pleaded	pled
plectra	plectrums
pleiades	pleiads
plenipoes	plenipos
pleurae	pleuras
plexus	plexuses
pluses	plusses
pneumothoraces	pneumothoraxes
pocketfuls	pocketsful
podia	podiums
poi	pois
poled	polled
polies	polys
poling	polling
politicoes	politicos
polyhedra	polyhedrons
polyneuritides	polyneuritises
pommeled	pommelled
pommeling	pommelling
poofs	pooves
porticoes	porticos
portmanteaus	portmanteaux
poses	posses
positifs	positives
pox	poxes
precalculi	precalculuses
precanceled	precancelled
precanceling	precancelling
precis	precises
prefocused	prefocussed
prefocuses	prefocusses
prefocusing	prefocussing
premixed	premixt
preprogramed	preprogrammed
preprograming	preprogramming
prepupae	prepupas
preses	presses
preshowed	preshown
preshrank	preshrunk	preshrunken
presidia	presidiums
presterna	presternums
preworked	prewrought
prexes	prices
preyer	prier
pries	prys
primiparae	primiparas
proboscides	proboscises
procambia	procambiums
profs	proves
proglottides	proglottids
programed	programmed
programing	programming
pronatores	pronators
prongbuck	prongbucks
pronuclei	pronucleuses
pronunciamentoes	pronunciamentos
proscenia	prosceniums
prosciutti	prosciuttos
prosecutrices	prosecutrixes
proses	prosses
prothoraces	prothoraxes
protocoled	protocolled
protocoling	protocolling
protozoa	protozoans	protozoons
proved	proven
provisoes	provisos
pseudomonades	pseudomonads
psyches	psychs
pubes	pubises
puled	pulled
puling	pulling
puma	pumas
pummeled	pummelled
pummeling	pummelling
pupae	pupas
pured	pureed
puses	pusses
pylori	pyloruses
pyramides	pyramids
pyroses	pyrosises
quadrennia	quadrenniums
quadriceps	quadricepses
quadrivia	quadriviums
quaiches	quaichs
quarreled	quarrelled
quarreling	quarrelling	quarrellings
quarterstaffs	quarterstaves
quetzales	quetzals
queueing	queuing
quezales	quezals
quit	quitted
quiting	quitting
quizes	quizzes
rabbies	rabbis
rabies	rabis
radices	radixes
radii	radiuses
radiolabeled	radiolabelled
radiolabeling	radiolabelling
railbuses	railbusses
rappeled	rappelled
rappeling	rappelling
rases	rasses
raveled	ravelled
raveling	ravelling	ravellings
razed	razeed
readding	reading
reales	reals	reis
reawaked	reawoke	reawoken
rebatoes	rebatos
rebid	rebidden
rebroadcast	rebroadcasted
rebuilded	rebuilt
recced	recceed
rechanneled	rechannelled
rechanneling	rechannelling
reclad	reclothed
recta	rectums
red	redded
redialed	redialled
redialing	redialling
redreamed	redreamt
redyeing	redying
reedbuck	reedbucks
reefs	reeves
reeved	rove
refed	reffed
referenda	referendums
refit	refitted
refocused	refocussed
refocuses	refocusses
refocusing	refocussing
reformadoes	reformados
refueled	refuelled
refueling	refuelling
regilded	regilt
reifs	reives
reindeer	reindeers
relabeled	relabelled
relabeling	relabelling
relearned	relearnt
reliefs	relieves
relighted	relit
remodeled	remodelled
remodeling	remodelling
rended	rent
rendezvous	rendezvouses
renegadoes	renegados
repaneled	repanelled
repaneling	repanelling
repleaded	repled
reprogramed	reprogrammed
reprograming	reprogramming
reproved	reproven
resewed	resewn
reshaved	reshaven
reshowed	reshown
residua	residuums
resowed	resown
respelled	respelt
respoke	respoken
resprang	resprung
restricken	restruck
retinae	retinas
retotaled	retotalled
retotaling	retotalling
reveled	revelled
reveling	revelling	revellings
revers	reverses
revictualed	revictualled
revictualing	revictualling
rewaked	rewoke	rewoken
reweaved	rewove	rewoven
rewinded	rewound
reworked	rewrought
rewrapped	rewrapt
rexes	rices
rhinoceri	rhinoceroses
rhombi	rhombuses
rhomboides	rhomboids
ricocheted	ricochetted
ricocheting	ricochetting
rid	ridded
rigatoni	rigatonis
ripsawed	ripsawn
rivaled	rivalled
rivaling	rivalling
rived	riven
riveted	rivetted
riveting	rivetting
rogueing	roguing
rostra	rostrums
rotatores	rotators
routeing	routing
roweled	rowelled
roweling	rowelling
rubati	rubatos
rueing	ruing
rupiah	rupiahs
russeting	russetting
sackfuls	sacksful
sacra	sacrums
safes	saves
saith	says
salespeople	salespersons
salmagundies	salmagundis
salmonella	salmonellae	salmonellas
salvoes	salvos
samurai	samurais
sanatoria	sanatoriums
sancta	sanctums
sandaled	sandalled
sandaling	sandalling
sandgrouse	sandgrouses
sanitaria	sanitariums
sank	sunk	sunken
sarcomas	sarcomata
sarcophagi	sarcophaguses
sash	sashes
sauted	sauteed
sauteing	sauting
sawbones	sawboneses
sawed	sawn
scampi	scampies	scampis
scandaled	scandalled
scandaling	scandalling
scapulae	scapulas
scarfs	scarves
schemas	schemata
scherzi	scherzos
schmoes	schmos
schnapps	schnappses
schnaps	schnapses
schnozes	schnozzes
schrod	schrods
scintillae	scintillas
scrod	scrods
scrota	scrotums
seethed	sod	sodden
segueing	seguing
semidwarfs	semidwarves
semihoboes	semihobos
senhores	senhors
senores	senors
sentineled	sentinelled
sentineling	sentinelling
septa	septums
sequined	sequinned
sera	serons	serums
seraphim	seraphims	seraphs
serfs	serves
servicepeople	servicepersons
sewed	sewn
sexes	sices	sixes
shackoes	shackos
shakoes	shakos
shall	shalt
shanties	shantis
shat	shit
shaved	shaven
sheafs	sheaves
sheared	shorn
shier	shyer
shiest	shyest
shindies	shindys
shinleafs	shinleaves
shod	shodden	shoed
shoes	shoon
shortwaveing	shortwaving
shoveled	shovelled
shovelfuls	shovelsful
shoveling	shovelling
showed	shown
shrank	shrunk	shrunken
shrived	shriven	shrove
shriveled	shrivelled
shriveling	shrivelling
sicced	sicked
siccing	sicking
signaled	signalled
signaling	signalling
signoras	signore
signori	signors
signorinas	signorine
simplexes	simplices
simulcast	simulcasted
singeing	singing
sises	sisses
sixpence	sixpences
sjamboked	sjambokked
sjamboking	sjambokking
ski	skies	skis
skied	skyed
skydived	skydove
slier	slyer
sliest	slyest
slinked	slunk
slueing	sluing
smelled	smelt
smit	smitten	smote
smoothes	smooths
snapshot	snapshotted
sneaked	snuck
sniveled	snivelled
sniveling	snivelling
snorkeled	snorkelled
snorkeling	snorkelling
socks	sox
solaria	solariums
soli	solos
solidi	soliduses
somerseted	somersetted
somerseting	somersetting
sonneted	sonnetted
sonneting	sonnetting
sordes	sords
soroses	sorosises
sowed	sown
spacecraft	spacecrafts
spadices	spadixes
spadoes	spados
spake	spoke	spoken
spanceled	spancelled
spanceling	spancelling
spat	spats	spit
spec'd	specced	specked
spec'ing	speccing	specking
spectra	spectrums
sped	speeded
spelled	spelt
sphinges	sphinxes
spilled	spilt
spiraled	spiralled
spiraling	spiralling
spoiled	spoilt
spokespeople	spokespersons
spoonfuls	spoonsful
spotlighted	spotlit
sprang	sprung
sprier	spryer
spriest	spryest
springbuck	springbucks
springeing	springing
squash	squashes
squirreled	squirrelled
squirreling	squirrelling
staccati	staccatos
stadia	stadiums
staffs	staves
stag	stags
staid	stayed
stainless	stainlesses
stank	stunk
staved	stove
stegosauri	stegosauruses
stembuck	stembucks
stenciled	stencilled
stenciling	stencilling	stencillings
sterna	sternums
sticcadoes	sticcados
stilettoes	stilettos
stomatitides	stomatitises
strapless	straplesses
strappadoes	strappados
strata	stratums
strati	stratuses
stratovolcanoes	stratovolcanos
strewed	strewn
stricken	struck
strifes	strives
stripped	stript
strived	striven	strove
stuccoes	stuccos
styli	stylos	styluses
stylopodia	stylopodiums
stymieing	stymying
subdeliria	subdeliriums
subgenera	subgenuses
subimagines	subimagos
subindexes	subindices
submaxillae	submaxillas
subminima	subminimums
substrata	substratums
subtotaled	subtotalled
subtotaling	subtotalling
suffices	suffixes
sulfureted	sulfuretted
sulfureting	sulfuretting
sunburned	sunburnt
sundries	sundris
supercargoes	supercargos
superhelices	superhelixes
superheroes	superheros
supernovae	supernovas
superphenomena	superphenomenons
superstrata	superstratums
supervirtuosi	supervirtuosos
surplused	surplussed
surplusing	surplussing
swamies	swamis
swan	swans
sweat	sweated
swelled	swollen
swingeing	swinging
swiveled	swivelled
swiveling	swivelling
syllabi	syllabuses
symboled	symbolled
symboling	symbolling
symposia	symposiums
syndeses	syndesises
syneses	synesises
syngases	syngasses
synopses	synopsises
syntheses	synthesises
tableaus	tableaux
tablespoonfuls	tablespoonsful
tableted	tabletted
tableting	tabletting
taces	taxes
taches	tachs
talced	talcked
talcing	talcking
tarantases	tarantasses
tarantulae	tarantulas
tasseled	tasselled
tasseling	tasselling	tassellings
taxies	taxis
taxiing	taxying
teacupfuls	teacupsful
teargases	teargasses
teaseled	teaselled
teaseling	teaselling
teaspoonfuls	teaspoonsful
teazeled	teazelled
teazeling	teazelling
teetotaled	teetotalled
teetotaling	teetotalling
telecast	telecasted
tellies	tellys
telneted	telnetted
telneting	telnetting
temblores	temblors
tempi	tempos
tenderfeet	tenderfoots
termini	terminuses
terraria	terrariums
testatrices	testatrixes
tetrahedra	tetrahedrons
thermostated	thermostatted
thermostating	thermostatting
thesauri	thesauruses
thoraces	thoraxes
threepence	threepences
thrived	thriven	throve
thrust	thrusted
thunderstricken	thunderstruck
thymi	thymuses
tibiae	tibias
ticced	ticked
ticcing	ticking
tieing	tyeing	tying
tiled	tilled
tiling	tilling
tingeing	tinging
tinseled	tinselled
tinseling	tinselling
tiroes	tiros
tittuped	tittupped
tittuping	tittupping
tobaccoes	tobaccos
togae	togas
toged	togged
tomatilloes	tomatillos
ton	tons
tornadoes	tornados
torpedoes	torpedos
torsi	torsoes	torsos
tortrices	tortrixes
tossed	tost
totaled	totalled
totaling	totalling
toweled	towelled
toweling	towelling	towellings
tracheae	tracheas
tradesfolk	tradesfolks
tradespeople	tradespersons
traditores	traditors
trameled	tramelled
trameling	tramelling
trammeled	trammelled
trammeling	trammelling
tranquiler	tranquiller
tranquilest	tranquillest
transfixed	transfixt
transited	transitted
transiting	transitting
trapezia	trapeziums
traumas	traumata
traveled	travelled
traveler	traveller
traveling	travelling	travellings
triceps	tricepses
triceratops	triceratopses
trichinae	trichinas
trilbies	trilbys
trod	trodden
trolleybuses	trolleybusses
troubleshooted	troubleshot
trousseaus	trousseaux
troweled	trowelled
troweling	trowelling
trueing	truing
tunneled	tunnelled
tunneling	tunnelling	tunnellings
turfs	turves
tutties	tuttis
tuxedoes	tuxedos
twingeing	twinging
tympana	tympanums
tympani	tympanies
tyroes	tyros
uglies	uglis
ulnae	ulnas
ultimas	ultimata	ultimatums
ultravacua	ultravacuums
umbilici	umbilicuses
umbrae	umbras
unbegot	unbegotten
unbeliefs	unbelieves
unbespoke	unbespoken
unbiased	unbiassed
unblessed	unblest
unborn	unborne
unclad	unclothed
underclad	underclothed
undergirded	undergirt
underworked	underwrought
ungilded	ungilt
ungirded	ungirt
unglueing	ungluing
ungot	ungotten
unkenneled	unkennelled
unkenneling	unkennelling
unladed	unladen
unlearned	unlearnt
unleveled	unlevelled
unleveling	unlevelling
unpeople	unpersons
unraveled	unravelled
unraveling	unravelling	unravellings
unreeved	unrove
unshod	unshoed
unspared	unsparred
unsparing	unsparring
unspoke	unspoken
unstriped	unstripped
untiled	untilled
untrod	untrodden
unworked	unwrought
up	upped
upspake	upspoke	upspoken
upsprang	upsprung
urethrae	urethras
uteri	uteruses
uveitides	uveitises
uvulae	uvulas
vacua	vacuums
vaginae	vaginas
veges	vegs
vermicelli	vermicellis
verrucae	verrucas
vertebrae	vertebras
vertexes	vertices
vertigines	vertigoes	vertigos
viae	vias
vialed	vialled
vialing	vialling
viatores	viators
victualed	victualled
victualing	victualling
villae	villas
viragoes	viragos
virtuosi	virtuosos
vised	viseed
viseing	vising
vitae	vitas
vitrioled	vitriolled
vitrioling	vitriolling
vivaces	vivaxes
vivaria	vivariums
vogueing	voguing
volcanoes	volcanos
vortexes	vortices
vulvae	vulvas
wackoes	wackos
wadies	wadis
waifs	waives
wainscoted	wainscotted
wainscoting	wainscotting
waitpeople	waitpersons
waked	woke	woken
waldoes	waldos
walies	walis
warwolf	warwolves
was	wast
water	watter
waterbuck	waterbucks
waterbuses	waterbusses
waxed	waxen
weaseled	weaselled
weaseling	weaselling
wed	wedded
weirdoes	weirdos
wended	went
wendigoes	wendigos
werewolf	werewolves
wet	wetted
whackoes	whackos
wharfs	wharves
whingeing	whinging
whipsawed	whipsawn
wildfowl	wildfowls
will	wilt
windburned	windburnt
winded	wound
windigoes	windigos
wingeing	winging
winoes	winos
wireless	wirelesses
wises	wisses
wit	wite
wizes	wizzes
wolf	wolves
wolverine	wolverines
womenfolk	womenfolks
worked	wrought
workfolk	workfolks
worshiped	worshipped
worshiping	worshipping
would	wouldst
wrapped	wrapt
wrier	wryer
wriest	wryest
writ	written
yesed	yessed
yeses	yesses
yeshivahs	yeshivas	yeshivoth
yesing	yessing
yobboes	yobbos
yodeled	yodelled
yodeling	yodelling
zemindaries	zemindaris
zeroes	zeros
zinced	zincked
zincing	zincking
zincks	zincs
zloties	zlotys
zucchini	zucchinis
